Rk,Player,School,Conf,G,Rec,Yds,Avg,TD,Att,Yds,Avg,TD,Plays,Yds,Avg,TD,-9999
1,Geraud Sanders*,Air Force,MWC,13,30,746,24.9,7,2,-36,-18.0,0,32,710,22.2,7,geraud-sanders-1
2,Simi Fehoko,Stanford,Pac-12,12,24,566,23.6,6,0,0,,0,24,566,23.6,6,simi-fehoko-1
3,CeeDee Lamb*,Oklahoma,Big 12,13,62,1327,21.4,14,9,20,2.2,1,71,1347,19.0,15,ceedee-lamb-1
4,Ja'Marr Chase*,LSU,SEC,14,84,1780,21.2,20,1,5,5.0,0,85,1785,21.0,20,jamarr-chase-1
5,Marquez Callaway*,Tennessee,SEC,13,30,635,21.2,6,0,0,,0,30,635,21.2,6,marquez-callaway-1
6,Kendall Parham*,UAB,CUSA,13,29,608,21.0,6,1,11,11.0,0,30,619,20.6,6,kendall-parham-1
7,Tarique Milton*,Iowa State,Big 12,13,35,722,20.6,3,0,0,,0,35,722,20.6,3,tarique-milton-1
8,Rashod Bateman*,Minnesota,Big Ten,13,60,1219,20.3,11,0,0,,0,60,1219,20.3,11,rashod-bateman-1
9,Dyami Brown*,North Carolina,ACC,13,51,1034,20.3,12,1,2,2.0,0,52,1036,19.9,12,dyami-brown-1
10,Frank Darby*,Arizona State,Pac-12,13,31,616,19.9,8,0,0,,0,31,616,19.9,8,frank-darby-1
11,Tamorrion Terry*,Florida State,ACC,13,60,1188,19.8,9,4,9,2.3,0,64,1197,18.7,9,tamorrion-terry-1
12,Tee Higgins*,Clemson,ACC,15,59,1167,19.8,13,1,36,36.0,1,60,1203,20.1,14,tee-higgins-1
13,Shane Hooks*,Ohio,MAC,10,26,515,19.8,5,0,0,,0,26,515,19.8,5,shane-hooks-1
14,Shane Hooks*,Ohio,MAC,13,26,515,19.8,5,0,0,,0,26,515,19.8,5,shane-hooks-2
15,Nico Collins*,Michigan,Big Ten,12,37,729,19.7,7,0,0,,0,37,729,19.7,7,nico-collins-1
16,Jyaire Shorter,North Texas,CUSA,12,24,473,19.7,9,0,0,,0,24,473,19.7,9,jyaire-shorter-1
17,Bryce Mitchell,Toledo,MAC,12,35,679,19.4,4,0,0,,0,35,679,19.4,4,bryce-mitchell-1
18,Austin Maloney*,Florida International,CUSA,13,33,639,19.4,2,0,0,,0,33,639,19.4,2,austin-maloney-1
19,Antonio Gibson*,Memphis,American,14,38,735,19.3,8,33,369,11.2,4,71,1104,15.5,12,antonio-gibson-2
20,Jalen Tolbert,South Alabama,Sun Belt,12,27,521,19.3,6,0,0,,0,27,521,19.3,6,jalen-tolbert-1
21,Austin Watkins*,UAB,CUSA,14,57,1092,19.2,6,1,-1,-1.0,0,58,1091,18.8,6,austin-watkins-1
22,Josh Imatorbhebhe*,Illinois,Big Ten,11,33,634,19.2,9,0,0,,0,33,634,19.2,9,josh-imatorbhebhe-1
23,Jordan Kress,New Mexico,MWC,10,28,530,18.9,6,0,0,,0,28,530,18.9,6,jordan-kress-1
24,Jordan Kress,New Mexico,MWC,12,28,530,18.9,6,0,0,,0,28,530,18.9,6,jordan-kress-2
25,Reggie Roberson Jr.*,SMU,American,8,43,803,18.7,6,2,7,3.5,0,45,810,18.0,6,reggie-roberson-jr-1
26,Henry Ruggs III*,Alabama,SEC,12,40,746,18.7,7,2,75,37.5,1,42,821,19.5,8,henry-ruggs-iii-1
27,Yo'Heinz Tyler,Ball State,MAC,12,27,504,18.7,5,0,0,,0,27,504,18.7,5,yoheinz-tyler-1
28,DeVonta Smith*,Alabama,SEC,13,68,1256,18.5,14,0,0,,0,68,1256,18.5,14,devonta-smith-1
29,John Hightower*,Boise State,MWC,14,51,943,18.5,8,16,154,9.6,0,67,1097,16.4,8,john-hightower-1
30,Quez Watkins*,Southern Mississippi,CUSA,12,64,1178,18.4,6,1,1,1.0,0,65,1179,18.1,6,quez-watkins-1
31,Brandon Aiyuk*,Arizona State,Pac-12,12,65,1192,18.3,8,1,6,6.0,0,66,1198,18.2,8,brandon-aiyuk-1
32,JD Spielman,Nebraska,Big Ten,12,49,898,18.3,5,4,31,7.8,0,53,929,17.5,5,jd-spielman-1
33,Chatarius Atwell*,Louisville,ACC,13,70,1276,18.2,12,8,29,3.6,0,78,1305,16.7,12,chatarius-atwell-1
34,Hunter Long*,Boston College,ACC,13,28,509,18.2,2,0,0,,0,28,509,18.2,2,hunter-long-3
35,Dez Fitzpatrick*,Louisville,ACC,13,35,635,18.1,6,0,0,,0,35,635,18.1,6,dez-fitzpatrick-1
36,Jahan Dotson*,Penn State,Big Ten,13,27,488,18.1,5,2,0,0.0,0,29,488,16.8,5,jahan-dotson-1
37,Griffin Hebert*,Louisiana Tech,CUSA,13,30,537,17.9,6,0,0,,0,30,537,17.9,6,griffin-hebert-1
38,Omar Bayless*,Arkansas State,Sun Belt,13,93,1653,17.8,17,0,0,,0,93,1653,17.8,17,omar-bayless-1
39,Antonio Gandy-Golden*,Liberty,Ind,13,79,1396,17.7,10,0,0,,0,79,1396,17.7,10,antonio-gandy-golden-1
40,Brant Kuithe*,Utah,Pac-12,14,34,602,17.7,6,6,102,17.0,3,40,704,17.6,9,brant-kuithe-1
41,Jacob Cowing,UTEP,CUSA,12,31,550,17.7,3,0,0,,0,31,550,17.7,3,jacob-cowing-1
42,Alec Pierce*,Cincinnati,American,14,37,652,17.6,2,0,0,,0,37,652,17.6,2,alec-pierce-2
43,Tyrone Scott*,Central Michigan,MAC,14,37,650,17.6,5,1,15,15.0,0,38,665,17.5,5,tyrone-scott-1
44,Victor Tucker*,Charlotte,CUSA,13,52,909,17.5,7,3,18,6.0,1,55,927,16.9,8,victor-tucker-1
45,Reginald Todd,Troy,Sun Belt,12,38,666,17.5,5,0,0,,0,38,666,17.5,5,reginald-todd-1
46,JoJo Ward*,Hawaii,MWC,15,65,1134,17.4,11,0,0,,0,65,1134,17.4,11,jojo-ward-1
47,Marquez Stevenson,Houston,American,12,52,907,17.4,9,9,89,9.9,0,61,996,16.3,9,marquez-stevenson-1
48,Tyquan Thornton*,Baylor,Big 12,14,45,782,17.4,5,0,0,,0,45,782,17.4,5,tyquan-thornton-1
49,Chris Olave*,Ohio State,Big Ten,14,49,849,17.3,12,2,5,2.5,0,51,854,16.7,12,chris-olave-1
50,Charleston Rambo*,Oklahoma,Big 12,14,43,743,17.3,5,2,15,7.5,0,45,758,16.8,5,charleston-rambo-1
51,Scotty Washington*,Wake Forest,ACC,8,35,607,17.3,7,0,0,,0,35,607,17.3,7,scotty-washington-1
52,Camden Harrison,Army,Ind,12,25,433,17.3,3,0,0,,0,25,433,17.3,3,camden-harrison-1
53,Gabriel Davis*,UCF,American,12,72,1241,17.2,12,0,0,,0,72,1241,17.2,12,gabriel-davis-1
54,Cedric Peterson,Arizona,Pac-12,12,24,412,17.2,2,0,0,,0,24,412,17.2,2,cedric-peterson-1
55,Danzel Mckinley-Lewis,Toledo,MAC,12,36,615,17.1,1,0,0,,0,36,615,17.1,1,danzel-mckinley-lewis-1
56,Tylan Wallace*,Oklahoma State,Big 12,9,53,903,17.0,8,1,0,0.0,0,54,903,16.7,8,tylan-wallace-1
57,Isiah Cox*,Ohio,MAC,13,39,663,17.0,2,1,15,15.0,0,40,678,17.0,2,isiah-cox-1
58,Jaylen Waddle*,Alabama,SEC,13,33,560,17.0,6,1,5,5.0,0,34,565,16.6,6,jaylen-waddle-1
59,Damon Hazelton Jr.*,Virginia Tech,ACC,10,31,527,17.0,8,1,3,3.0,0,32,530,16.6,8,damon-hazelton-jr-1
60,Tre Nixon*,UCF,American,13,49,830,16.9,7,0,0,,0,49,830,16.9,7,tre-nixon-1
61,Damonte Coxie*,Memphis,American,14,76,1276,16.8,9,0,0,,0,76,1276,16.8,9,damonte-coxie-1
62,Keylon Stokes,Tulsa,American,12,62,1040,16.8,6,9,42,4.7,0,71,1082,15.2,6,keylon-stokes-1
63,C.J. Johnson,East Carolina,American,12,54,908,16.8,4,0,0,,0,54,908,16.8,4,cj-johnson-6
64,Kylen Granson*,SMU,American,13,43,721,16.8,9,2,11,5.5,0,45,732,16.3,9,kylen-granson-1
65,Steve Jenkins,UNLV,MWC,11,23,386,16.8,2,1,7,7.0,0,24,393,16.4,2,steve-jenkins-3
66,Isaiah Hamilton,San Jose State,MWC,12,43,718,16.7,4,7,32,4.6,0,50,750,15.0,4,isaiah-hamilton-2
67,Dashon Bussell*,Western Michigan,MAC,13,27,445,16.5,2,0,0,,0,27,445,16.5,2,dashon-bussell-1
68,Marcus Williams,New Mexico,MWC,12,26,428,16.5,1,0,0,,0,26,428,16.5,1,marcus-williams-11
69,Jauan Jennings*,Tennessee,SEC,13,59,969,16.4,8,13,51,3.9,1,72,1020,14.2,9,jauan-jennings-1
70,Ihmir Smith-Marsette*,Iowa,Big Ten,13,44,722,16.4,5,11,108,9.8,3,55,830,15.1,8,ihmir-smith-marsette-1
71,Tyrone Tracy Jr.*,Iowa,Big Ten,13,36,589,16.4,3,6,39,6.5,1,42,628,15.0,4,tyrone-tracy-jr-1
72,Kawaan Baker,South Alabama,Sun Belt,12,35,574,16.4,3,20,83,4.2,2,55,657,11.9,5,kawaan-baker-1
73,Treylon Burks,Arkansas,SEC,11,29,475,16.4,0,9,35,3.9,0,38,510,13.4,0,treylon-burks-1
74,Myron Mitchell*,UAB,CUSA,14,34,554,16.3,4,1,4,4.0,0,35,558,15.9,4,myron-mitchell-1
75,Tre Turner*,Virginia Tech,ACC,11,34,553,16.3,4,24,231,9.6,1,58,784,13.5,5,tre-turner-2
76,Brennan Eagles*,Texas,Big 12,12,32,522,16.3,6,0,0,,0,32,522,16.3,6,brennan-eagles-1
77,Stephan Robinson,Kansas,Big 12,12,45,727,16.2,8,4,13,3.3,0,49,740,15.1,8,stephan-robinson-2
78,Malik Stanley*,Louisiana Tech,CUSA,13,40,649,16.2,3,0,0,,0,40,649,16.2,3,malik-stanley-1
79,Jamarye Joiner,Arizona,Pac-12,12,34,552,16.2,5,0,0,,0,34,552,16.2,5,jamarye-joiner-1
80,KJ Hamler*,Penn State,Big Ten,13,56,904,16.1,8,13,43,3.3,0,69,947,13.7,8,kj-hamler-1
81,Rashee Rice*,SMU,American,10,25,403,16.1,1,1,0,0.0,0,26,403,15.5,1,rashee-rice-1
82,Spencer Tears,Northern Illinois,MAC,12,23,370,16.1,2,1,6,6.0,0,24,376,15.7,2,spencer-tears-1
83,Binjimen Victor*,Ohio State,Big Ten,14,34,545,16.0,6,0,0,,0,34,545,16.0,6,binjimen-victor-1
84,Hunter Bryant*,Washington,Pac-12,12,52,825,15.9,3,2,-4,-2.0,0,54,821,15.2,3,hunter-bryant-2
85,Arthur Jackson III*,Eastern Michigan,MAC,13,46,732,15.9,7,0,0,,0,46,732,15.9,7,arthur-jackson-iii-1
86,Kobay White*,Boston College,ACC,13,29,460,15.9,5,4,19,4.8,0,33,479,14.5,5,kobay-white-1
87,Ronnie Bell*,Michigan,Big Ten,13,48,758,15.8,1,1,9,9.0,0,49,767,15.7,1,ronnie-bell-3
88,Randal Grimes,UNLV,MWC,11,44,696,15.8,7,0,0,,0,44,696,15.8,7,randal-grimes-1
89,Erik Ezukanma,Texas Tech,Big 12,12,42,664,15.8,4,0,0,,0,42,664,15.8,4,erik-ezukanma-1
90,Tavaris Harrison*,Florida Atlantic,CUSA,13,33,523,15.8,2,0,0,,0,33,523,15.8,2,tavaris-harrison-1
91,Tyler Ringwood*,Charlotte,CUSA,13,25,395,15.8,5,0,0,,0,25,395,15.8,5,tyler-ringwood-1
92,Chase Claypool*,Notre Dame,Ind,13,66,1037,15.7,13,0,0,,0,66,1037,15.7,13,chase-claypool-1
93,Siaosi Mariner*,Utah State,MWC,13,63,987,15.7,10,0,0,,0,63,987,15.7,10,siaosi-mariner-1
94,Skyy Moore*,Western Michigan,MAC,13,51,802,15.7,3,1,2,2.0,1,52,804,15.5,4,skyy-moore-1
95,Jalen McCleskey*,Tulane,American,13,37,581,15.7,4,1,-1,-1.0,0,38,580,15.3,4,jalen-mccleskey-1
96,Bailey Gaither,San Jose State,MWC,12,52,812,15.6,6,0,0,,0,52,812,15.6,6,bailey-gaither-1
97,Kedarian Jones*,Memphis,American,14,39,609,15.6,4,2,10,5.0,0,41,619,15.1,4,kedarian-jones-1
98,Dalton Schoen*,Kansas State,Big 12,13,37,579,15.6,4,1,4,4.0,0,38,583,15.3,4,dalton-schoen-1
99,Juwan Johnson*,Oregon,Pac-12,10,30,467,15.6,4,0,0,,0,30,467,15.6,4,juwan-johnson-1
100,Trishton Jackson,Syracuse,ACC,12,66,1023,15.5,11,2,3,1.5,0,68,1026,15.1,11,trishton-jackson-1
101,Denzel Mims*,Baylor,Big 12,14,66,1020,15.5,12,0,0,,0,66,1020,15.5,12,denzel-mims-1
102,Tyler Johnson*,Minnesota,Big Ten,11,72,1107,15.4,10,0,0,,0,72,1107,15.4,10,tyler-johnson-6
103,Harrison Bryant*,Florida Atlantic,CUSA,13,65,1004,15.4,7,0,0,,0,65,1004,15.4,7,harrison-bryant-1
104,Branden Mack*,Temple,American,13,59,904,15.3,7,2,14,7.0,0,61,918,15.0,7,branden-mack-1
105,Quintez Cephus*,Wisconsin,Big Ten,14,59,901,15.3,7,0,0,,0,59,901,15.3,7,quintez-cephus-1
106,Isaiah McKoy*,Kent State,MAC,12,57,870,15.3,8,0,0,,0,57,870,15.3,8,isaiah-mckoy-1
107,Sage Surratt*,Wake Forest,ACC,9,66,1001,15.2,11,0,0,,0,66,1001,15.2,11,sage-surratt-1
108,Dontay Demus,Maryland,Big Ten,12,41,625,15.2,6,1,4,4.0,0,42,629,15.0,6,dontay-demus-1
109,Cary Angeline,North Carolina State,ACC,12,25,379,15.2,5,0,0,,0,25,379,15.2,5,cary-angeline-1
110,Jerry Jeudy*,Alabama,SEC,13,77,1163,15.1,10,1,1,1.0,0,78,1164,14.9,10,jerry-jeudy-1
111,Ja'Marcus Bradley*,Louisiana,Sun Belt,14,60,906,15.1,10,0,0,,0,60,906,15.1,10,jamarcus-bradley-1
112,Taj Harris,Syracuse,ACC,12,37,559,15.1,2,2,25,12.5,0,39,584,15.0,2,taj-harris-1
113,Tony Poljan*,Central Michigan,MAC,12,33,496,15.0,4,0,0,,0,33,496,15.0,4,tony-poljan-1
114,Aaron Moore,Old Dominion,CUSA,12,26,389,15.0,3,0,0,,0,26,389,15.0,3,aaron-moore-4
115,Darnell Mooney*,Tulane,American,13,48,713,14.9,5,0,0,,0,48,713,14.9,5,darnell-mooney-1
116,Mathew Sexton*,Eastern Michigan,MAC,11,34,508,14.9,4,5,14,2.8,0,39,522,13.4,4,mathew-sexton-1
117,Trevon Grimes*,Florida,SEC,13,33,491,14.9,3,1,-4,-4.0,0,34,487,14.3,3,trevon-grimes-1
118,George Pickens*,Georgia,SEC,14,49,727,14.8,8,0,0,,0,49,727,14.8,8,george-pickens-1
119,Romeo Doubs*,Nevada,MWC,11,44,649,14.8,4,1,-1,-1.0,0,45,648,14.4,4,romeo-doubs-1
120,Jonathan Nance,Missouri,SEC,12,31,458,14.8,4,1,4,4.0,0,32,462,14.4,4,jonathan-nance-1
121,Osirus Mitchell*,Mississippi State,SEC,13,29,430,14.8,6,0,0,,0,29,430,14.8,6,osirus-mitchell-1
122,Tre Walker,San Jose State,MWC,10,79,1161,14.7,2,0,0,,0,79,1161,14.7,2,tre-walker-3
123,Johnny Johnson III*,Oregon,Pac-12,14,57,836,14.7,7,0,0,,0,57,836,14.7,7,johnny-johnson-iii-1
124,Corey Sutton*,Appalachian State,Sun Belt,9,41,601,14.7,7,0,0,,0,41,601,14.7,7,corey-sutton-2
125,Collin Johnson*,Texas,Big 12,7,38,559,14.7,3,0,0,,0,38,559,14.7,3,collin-johnson-2
126,Jimmy Marshall,Middle Tennessee State,CUSA,12,35,513,14.7,6,0,0,,0,35,513,14.7,6,jimmy-marshall-2
127,Malik Knowles*,Kansas State,Big 12,11,27,397,14.7,3,7,70,10.0,0,34,467,13.7,3,malik-knowles-1
128,Jeremy Singleton,Houston,American,12,26,381,14.7,3,0,0,,0,26,381,14.7,3,jeremy-singleton-1
129,Matt Bushman*,Brigham Young,Ind,13,47,688,14.6,4,0,0,,0,47,688,14.6,4,matt-bushman-1
130,Terrace Marshall Jr.*,LSU,SEC,12,46,671,14.6,13,0,0,,0,46,671,14.6,13,terrace-marshall-jr-1
131,Devin Asiasi,UCLA,Pac-12,12,44,641,14.6,4,0,0,,0,44,641,14.6,4,devin-asiasi-1
132,Cameron Dollar*,Charlotte,CUSA,13,41,599,14.6,2,1,-5,-5.0,0,42,594,14.1,2,cameron-dollar-1
133,Jordan Duncan*,California,Pac-12,11,25,364,14.6,2,0,0,,0,25,364,14.6,2,jordan-duncan-1
134,Warren Jackson,Colorado State,MWC,10,77,1119,14.5,8,0,0,,0,77,1119,14.5,8,warren-jackson-2
135,RJ Turner,Texas Tech,Big 12,12,45,654,14.5,3,0,0,,0,45,654,14.5,3,rj-turner-1
136,Drake London*,USC,Pac-12,13,39,567,14.5,5,0,0,,0,39,567,14.5,5,drake-london-1
137,Tray Eafford,Troy,Sun Belt,10,23,334,14.5,3,0,0,,0,23,334,14.5,3,tray-eafford-1
138,Beau Corrales*,North Carolina,ACC,13,40,575,14.4,6,0,0,,0,40,575,14.4,6,beau-corrales-1
139,Lawrence Cager*,Georgia,SEC,9,33,476,14.4,4,0,0,,0,33,476,14.4,4,lawrence-cager-1
140,Garrett Wilson*,Ohio State,Big Ten,14,30,432,14.4,5,0,0,,0,30,432,14.4,5,garrett-wilson-2
141,Whop Philyor*,Indiana,Big Ten,12,70,1002,14.3,5,10,43,4.3,0,80,1045,13.1,5,whop-philyor-1
142,Nate Stewart,Akron,MAC,12,37,529,14.3,3,0,0,,0,37,529,14.3,3,nate-stewart-1
143,Dalton Rigdon,Texas Tech,Big 12,10,34,486,14.3,5,6,12,2.0,0,40,498,12.5,5,dalton-rigdon-1
144,Champ Flemings,Oregon State,Pac-12,12,32,457,14.3,3,3,18,6.0,0,35,475,13.6,3,champ-flemings-1
145,Devin Carter,North Carolina State,ACC,12,32,456,14.3,0,0,0,,0,32,456,14.3,0,devin-carter-1
146,Joshua Simon*,Western Kentucky,CUSA,13,30,430,14.3,4,0,0,,0,30,430,14.3,4,joshua-simon-1
147,Nate Craig-Myers,Colorado State,MWC,9,23,329,14.3,1,0,0,,0,23,329,14.3,1,nate-craig-myers-1
148,Brandon Arconado*,Washington State,Pac-12,11,78,1109,14.2,7,0,0,,0,78,1109,14.2,7,brandon-arconado-1
149,Hasise Dubois*,Virginia,ACC,14,75,1062,14.2,6,0,0,,0,75,1062,14.2,6,hasise-dubois-1
150,JaCorey Sullivan*,Central Michigan,MAC,13,57,808,14.2,3,0,0,,0,57,808,14.2,3,jacorey-sullivan-1
151,Darrell Stewart Jr.*,Michigan State,Big Ten,9,49,697,14.2,4,2,-13,-6.5,0,51,684,13.4,4,darrell-stewart-jr-1
152,Riley Miller,Ball State,MAC,12,43,612,14.2,6,0,0,,0,43,612,14.2,6,riley-miller-1
153,Jalen Reagor,TCU,Big 12,12,43,611,14.2,5,14,89,6.4,0,57,700,12.3,5,jalen-reagor-1
154,Bo Melton,Rutgers,Big Ten,12,30,427,14.2,2,4,22,5.5,0,34,449,13.2,2,bo-melton-1
155,Amari Rodgers*,Clemson,ACC,14,30,426,14.2,4,2,50,25.0,1,32,476,14.9,5,amari-rodgers-1
156,Dazz Newsome*,North Carolina,ACC,12,72,1018,14.1,10,3,9,3.0,0,75,1027,13.7,10,dazz-newsome-1
157,Seth Williams*,Auburn,SEC,12,59,830,14.1,8,0,0,,0,59,830,14.1,8,seth-williams-1
158,Dante Wright,Colorado State,MWC,12,57,805,14.1,4,17,214,12.6,2,74,1019,13.8,6,dante-wright-1
159,Marlon Williams*,UCF,American,12,51,717,14.1,6,0,0,,0,51,717,14.1,6,marlon-williams-5
160,Brevin Jordan*,Miami (FL),ACC,11,35,495,14.1,2,1,0,0.0,0,36,495,13.8,2,brevin-jordan-1
161,Cody White*,Michigan State,Big Ten,13,66,922,14.0,6,6,22,3.7,0,72,944,13.1,6,cody-white-3
162,Brad Rozner,Rice,CUSA,12,55,770,14.0,5,0,0,,0,55,770,14.0,5,brad-rozner-1
163,Antonio Nunn*,Buffalo,MAC,12,49,687,14.0,6,0,0,,0,49,687,14.0,6,antonio-nunn-1
164,Cole Tucker,Northern Illinois,MAC,12,38,531,14.0,1,0,0,,0,38,531,14.0,1,cole-tucker-1
165,Jalen Wydermyer*,Texas A&M,SEC,13,32,447,14.0,6,0,0,,0,32,447,14.0,6,jalen-wydermyer-1
166,Tyrie Cleveland*,Florida,SEC,13,25,351,14.0,1,0,0,,0,25,351,14.0,1,tyrie-cleveland-1
167,Chase Cota,UCLA,Pac-12,12,25,350,14.0,3,0,0,,0,25,350,14.0,3,chase-cota-1
168,Justin Jefferson*,LSU,SEC,15,111,1540,13.9,18,0,0,,0,111,1540,13.9,18,justin-jefferson-1
169,Boogie Knight,Akron,MAC,12,31,430,13.9,0,1,3,3.0,0,32,433,13.5,0,boogie-knight-1
170,Zack Moss*,Utah,Pac-12,13,28,388,13.9,2,235,1416,6.0,15,263,1804,6.9,17,zack-moss-1
171,Khalil Shakir*,Boise State,MWC,14,63,872,13.8,6,19,66,3.5,3,82,938,11.4,9,khalil-shakir-1
172,Michael Lawrence,North Texas,CUSA,12,48,661,13.8,3,0,0,,0,48,661,13.8,3,michael-lawrence-1
173,Trey Knox,Arkansas,SEC,11,28,385,13.8,3,0,0,,0,28,385,13.8,3,trey-knox-1
174,Kendall Hinton*,Wake Forest,ACC,11,73,1001,13.7,4,2,9,4.5,0,75,1010,13.5,4,kendall-hinton-1
175,Jonathan Adams Jr.*,Arkansas State,Sun Belt,13,62,851,13.7,5,0,0,,0,62,851,13.7,5,jonathan-adams-jr-1
176,Charlie Kolar*,Iowa State,Big 12,13,51,697,13.7,7,0,0,,0,51,697,13.7,7,charlie-kolar-1
177,Isaiah Hodgins,Oregon State,Pac-12,12,86,1171,13.6,13,0,0,,0,86,1171,13.6,13,isaiah-hodgins-1
178,Brycen Hopkins,Purdue,Big Ten,12,61,830,13.6,7,0,0,,0,61,830,13.6,7,brycen-hopkins-1
179,Laviska Shenault Jr.,Colorado,Pac-12,11,56,764,13.6,4,23,161,7.0,2,79,925,11.7,6,laviska-shenault-jr-1
180,Nick Westbrook*,Indiana,Big Ten,13,42,572,13.6,5,0,0,,0,42,572,13.6,5,nick-westbrook-1
181,Freddie Swain*,Florida,SEC,12,38,517,13.6,7,4,27,6.8,0,42,544,13.0,7,freddie-swain-1
182,Antwan Davis,Ball State,MAC,12,38,516,13.6,3,0,0,,0,38,516,13.6,3,antwan-davis-2
183,Ardell Brown,Connecticut,American,11,27,368,13.6,2,0,0,,0,27,368,13.6,2,ardell-brown-1
184,Amon-Ra St. Brown*,USC,Pac-12,13,77,1042,13.5,6,7,60,8.6,1,84,1102,13.1,7,amon-ra-st-brown-1
185,Mike Carrigan*,Kent State,MAC,11,42,569,13.5,5,1,3,3.0,0,43,572,13.3,5,mike-carrigan-1
186,Nikko Remigio*,California,Pac-12,12,38,513,13.5,3,3,8,2.7,0,41,521,12.7,3,nikko-remigio-1
187,Isaiah Likely,Coastal Carolina,Sun Belt,12,32,431,13.5,5,0,0,,0,32,431,13.5,5,isaiah-likely-1
188,Van Jefferson*,Florida,SEC,13,49,657,13.4,6,1,7,7.0,0,50,664,13.3,6,van-jefferson-1
189,Ty Fryfogle*,Indiana,Big Ten,13,45,604,13.4,3,0,0,,0,45,604,13.4,3,ty-fryfogle-1
190,Jarrin Pierce,Middle Tennessee State,CUSA,12,42,562,13.4,4,1,9,9.0,0,43,571,13.3,4,jarrin-pierce-1
191,Deven Thompkins*,Utah State,MWC,12,40,536,13.4,4,6,77,12.8,1,46,613,13.3,5,deven-thompkins-1
192,Josh Palmer*,Tennessee,SEC,13,34,457,13.4,1,2,4,2.0,0,36,461,12.8,1,josh-palmer-1
193,Deddrick Thomas*,Mississippi State,SEC,13,30,401,13.4,2,1,5,5.0,0,31,406,13.1,2,deddrick-thomas-1
194,Austin Mack*,Ohio State,Big Ten,11,27,361,13.4,3,0,0,,0,27,361,13.4,3,austin-mack-1
195,K.D. Nixon,Colorado,Pac-12,12,35,465,13.3,3,5,19,3.8,0,40,484,12.1,3,kd-nixon-1
196,Rondale Moore,Purdue,Big Ten,4,29,387,13.3,2,3,3,1.0,0,32,390,12.2,2,rondale-moore-1
197,Chris Autman-Bell*,Minnesota,Big Ten,13,28,371,13.3,5,0,0,,0,28,371,13.3,5,chris-autman-bell-1
198,Kevin Shaa*,Liberty,Ind,11,26,346,13.3,2,0,0,,0,26,346,13.3,2,kevin-shaa-1
199,Jhamon Ausbon*,Texas A&M,SEC,13,66,872,13.2,5,0,0,,0,66,872,13.2,5,jhamon-ausbon-1
200,Sam Crawford Jr.,Tulsa,American,12,59,777,13.2,5,0,0,,0,59,777,13.2,5,sam-crawford-jr-1
201,Jesse Matthews*,San Diego State,MWC,13,48,633,13.2,2,1,7,7.0,0,49,640,13.1,2,jesse-matthews-1
202,Josh Pederson,Louisiana-Monroe,Sun Belt,12,43,567,13.2,9,0,0,,0,43,567,13.2,9,josh-pederson-1
203,Devin Duvernay*,Texas,Big 12,13,106,1386,13.1,9,10,24,2.4,1,116,1410,12.2,10,devin-duvernay-1
204,Justyn Ross*,Clemson,ACC,14,66,865,13.1,8,0,0,,0,66,865,13.1,8,justyn-ross-1
205,Dezmon Patmon*,Washington State,Pac-12,13,58,762,13.1,8,0,0,,0,58,762,13.1,8,dezmon-patmon-1
206,Shermar Thornton*,Florida International,CUSA,13,51,668,13.1,5,0,0,,0,51,668,13.1,5,shermar-thornton-1
207,Tay Martin*,Washington State,Pac-12,13,43,564,13.1,4,0,0,,0,43,564,13.1,4,tay-martin-1
208,Jamal Bell*,Louisiana,Sun Belt,14,34,445,13.1,1,0,0,,0,34,445,13.1,1,jamal-bell-1
209,Mitchell Brinkman,Northern Illinois,MAC,12,34,445,13.1,3,0,0,,0,34,445,13.1,3,mitchell-brinkman-1
210,Zachari Jackson,Louisiana-Monroe,Sun Belt,12,30,392,13.1,1,0,0,,0,30,392,13.1,1,zachari-jackson-1
211,Jared Smart*,Hawaii,MWC,15,87,1129,13.0,5,0,0,,0,87,1129,13.0,5,jared-smart-1
212,Talon Shumway*,Brigham Young,Ind,13,43,561,13.0,4,0,0,,0,43,561,13.0,4,talon-shumway-1
213,T.J. Simmons,West Virginia,Big 12,10,35,455,13.0,4,1,-4,-4.0,0,36,451,12.5,4,tj-simmons-4
214,Tyrice Richie,Northern Illinois,MAC,11,32,415,13.0,4,5,35,7.0,0,37,450,12.2,4,tyrice-richie-1
215,Tayvion Robinson*,Virginia Tech,ACC,13,31,404,13.0,1,11,132,12.0,0,42,536,12.8,1,tayvion-robinson-1
216,Jack Sorenson*,Miami (OH),MAC,11,44,568,12.9,4,0,0,,0,44,568,12.9,4,jack-sorenson-1
217,Josiah Deguara*,Cincinnati,American,14,39,504,12.9,7,0,2,,1,39,506,13.0,8,josiah-deguara-1
218,Carlos Strickland,UTSA,CUSA,12,38,492,12.9,4,0,0,,0,38,492,12.9,4,carlos-strickland-1
219,Zakhari Franklin,UTSA,CUSA,9,38,491,12.9,3,0,0,,0,38,491,12.9,3,zakhari-franklin-1
220,Donovan Peoples-Jones*,Michigan,Big Ten,11,34,438,12.9,6,2,-7,-3.5,0,36,431,12.0,6,donovan-peoples-jones-1
221,Stephen Guidry*,Mississippi State,SEC,12,30,387,12.9,5,0,0,,0,30,387,12.9,5,stephen-guidry-1
222,Ryan Luehrman*,Ohio,MAC,13,28,360,12.9,5,0,0,,0,28,360,12.9,5,ryan-luehrman-1
223,Tarik Black*,Michigan,Big Ten,12,25,323,12.9,1,0,0,,0,25,323,12.9,1,tarik-black-1
224,Andrew Parchment,Kansas,Big 12,12,65,831,12.8,7,1,0,0.0,0,66,831,12.6,7,andrew-parchment-1
225,John Mitchell*,Florida Atlantic,CUSA,14,38,488,12.8,5,0,0,,0,38,488,12.8,5,john-mitchell-1
226,Mike Harley*,Miami (FL),ACC,13,38,485,12.8,3,4,22,5.5,0,42,507,12.1,3,mike-harley-1
227,Sam Pinckney*,Georgia State,Sun Belt,9,36,460,12.8,5,0,0,,0,36,460,12.8,5,sam-pinckney-1
228,Michael Woods,Arkansas,SEC,12,33,423,12.8,4,0,0,,0,33,423,12.8,4,michael-woods-4
229,Taye Barber,TCU,Big 12,9,29,372,12.8,0,5,87,17.4,0,34,459,13.5,0,taye-barber-1
230,Josh Hammond*,Florida,SEC,13,27,346,12.8,2,6,101,16.8,1,33,447,13.5,3,josh-hammond-1
231,Donny Navarro*,Illinois,Big Ten,11,27,345,12.8,2,1,6,6.0,0,28,351,12.5,2,donny-navarro-1
232,Donny Navarro III*,Illinois,Big Ten,13,27,345,12.8,2,1,6,6.0,0,28,351,12.5,2,donny-navarro-iii-1
233,Elijah Moore,Ole Miss,SEC,12,67,850,12.7,6,4,-1,-0.3,0,71,849,12.0,6,elijah-moore-1
234,Thomas Hennigan*,Appalachian State,Sun Belt,14,61,773,12.7,6,1,4,4.0,0,62,777,12.5,6,thomas-hennigan-1
235,Quian Williams*,Eastern Michigan,MAC,13,52,661,12.7,6,0,0,,0,52,661,12.7,6,quian-williams-1
236,Adrian Hardy*,Louisiana Tech,CUSA,10,42,534,12.7,1,0,0,,0,42,534,12.7,1,adrian-hardy-1
237,CT Thomas*,Boise State,MWC,14,41,522,12.7,5,2,22,11.0,1,43,544,12.7,6,ct-thomas-1
238,Tre'shon Wolf,UTEP,CUSA,12,34,433,12.7,2,3,21,7.0,0,37,454,12.3,2,treshon-wolf-1
239,Luke Whittemore,Troy,Sun Belt,12,34,431,12.7,2,0,0,,0,34,431,12.7,2,luke-whittemore-1
240,Aaron Young,Duke,ACC,12,29,367,12.7,3,0,0,,0,29,367,12.7,3,aaron-young-3
241,Michael Pittman Jr.*,USC,Pac-12,13,101,1275,12.6,11,0,0,,0,101,1275,12.6,11,michael-pittman-jr-1
242,Deangleo Antoine*,Florida Atlantic,CUSA,13,61,771,12.6,5,8,146,18.3,1,69,917,13.3,6,deangleo-antoine-1
243,Tony Brown,Colorado,Pac-12,12,56,707,12.6,5,6,33,5.5,1,62,740,11.9,6,tony-brown-9
244,Giovanni Ricci*,Western Michigan,MAC,13,51,642,12.6,8,0,0,,0,51,642,12.6,8,giovanni-ricci-1
245,Caleb Repp*,Utah State,MWC,12,36,455,12.6,4,0,0,,0,36,455,12.6,4,caleb-repp-1
246,T.J. Graham,Texas State,Sun Belt,12,28,353,12.6,4,0,0,,0,28,353,12.6,4,tj-graham-2
247,Khalil McClain,Troy,Sun Belt,12,45,562,12.5,7,0,0,,0,45,562,12.5,7,khalil-mcclain-1
248,Daylon Charlot,Kansas,Big 12,12,33,413,12.5,2,0,0,,0,33,413,12.5,2,daylon-charlot-1
249,D.J. Stubbs*,Liberty,Ind,13,32,401,12.5,3,1,-12,-12.0,0,33,389,11.8,3,dj-stubbs-1
250,Mitchell Wilcox,South Florida,American,12,28,350,12.5,5,0,0,,0,28,350,12.5,5,mitchell-wilcox-1
251,Tim Jones*,Southern Mississippi,CUSA,13,73,902,12.4,3,1,-2,-2.0,0,74,900,12.2,3,tim-jones-8
252,Blake Proehl,East Carolina,American,12,54,670,12.4,4,0,0,,0,54,670,12.4,4,blake-proehl-1
253,Tony Gaiter IV*,Florida International,CUSA,13,50,622,12.4,4,0,0,,0,50,622,12.4,4,tony-gaiter-iv-1
254,Trey McBride,Colorado State,MWC,12,45,560,12.4,4,0,0,,0,45,560,12.4,4,trey-mcbride-1
255,Line Latu*,Eastern Michigan,MAC,13,30,373,12.4,3,6,19,3.2,0,36,392,10.9,3,line-latu-1
256,Tyler Vaughns*,USC,Pac-12,13,74,912,12.3,6,0,0,,0,74,912,12.3,6,tyler-vaughns-1
257,La'Michael Pettway*,Iowa State,Big 12,13,55,676,12.3,6,0,0,,0,55,676,12.3,6,lamichael-pettway-1
258,Colby Parkinson,Stanford,Pac-12,12,48,589,12.3,1,0,0,,0,48,589,12.3,1,colby-parkinson-1
259,Keenen Johnson,Tulsa,American,12,46,568,12.3,3,0,0,,0,46,568,12.3,3,keenen-johnson-1
260,T.J. Vasher,Texas Tech,Big 12,10,42,515,12.3,6,0,0,,0,42,515,12.3,6,tj-vasher-1
261,Jake Ferguson*,Wisconsin,Big Ten,14,33,407,12.3,2,0,0,,0,33,407,12.3,2,jake-ferguson-1
262,Peter LeBlanc*,Louisiana,Sun Belt,14,28,344,12.3,4,0,0,,0,28,344,12.3,4,peter-leblanc-1
263,Elijah Cooks*,Nevada,MWC,13,76,926,12.2,8,0,0,,0,76,926,12.2,8,elijah-cooks-1
264,Jeff Thomas*,Miami (FL),ACC,10,31,379,12.2,3,7,41,5.9,0,38,420,11.1,3,jeff-thomas-6
265,Gunner Romney*,Brigham Young,Ind,13,31,377,12.2,2,1,6,6.0,0,32,383,12.0,2,gunner-romney-1
266,Lucky Jackson*,Western Kentucky,CUSA,13,94,1133,12.1,4,1,15,15.0,0,95,1148,12.1,4,lucky-jackson-1
267,Austin Trammell,Rice,CUSA,12,60,726,12.1,4,2,13,6.5,0,62,739,11.9,4,austin-trammell-1
268,Cameron Ross,Connecticut,American,11,60,723,12.1,4,3,27,9.0,0,63,750,11.9,4,cameron-ross-1
269,Micah Simon*,Brigham Young,Ind,13,51,616,12.1,2,5,47,9.4,2,56,663,11.8,4,micah-simon-1
270,Markis McCray,Louisiana-Monroe,Sun Belt,12,48,583,12.1,6,8,81,10.1,0,56,664,11.9,6,markis-mccray-1
271,Thaddeus Moss*,LSU,SEC,14,47,570,12.1,4,0,0,,0,47,570,12.1,4,thaddeus-moss-1
272,David Bell,Purdue,Big Ten,12,86,1035,12.0,7,3,12,4.0,1,89,1047,11.8,8,david-bell-6
273,Terrell Jana*,Virginia,ACC,14,74,886,12.0,3,0,0,,0,74,886,12.0,3,terrell-jana-1
274,Michael Wilson,Stanford,Pac-12,12,56,672,12.0,5,0,0,,0,56,672,12.0,5,michael-wilson-3
275,Kyle Pitts*,Florida,SEC,13,54,649,12.0,5,0,0,,0,54,649,12.0,5,kyle-pitts-1
276,Peyton Hendershot*,Indiana,Big Ten,13,52,622,12.0,4,1,-4,-4.0,0,53,618,11.7,4,peyton-hendershot-1
277,Kenny Gainwell*,Memphis,American,14,51,610,12.0,3,231,1459,6.3,13,282,2069,7.3,16,kenny-gainwell-1
278,Armani Levias*,Marshall,CUSA,13,46,553,12.0,3,0,0,,0,46,553,12.0,3,armani-levias-1
279,Cole Kmet*,Notre Dame,Ind,11,43,515,12.0,6,0,0,,0,43,515,12.0,6,cole-kmet-1
280,Daniel Crawford,Northern Illinois,MAC,12,37,443,12.0,2,0,0,,0,37,443,12.0,2,daniel-crawford-1
281,Donta Thompson,Texas Tech,Big 12,12,26,311,12.0,0,0,0,,0,26,311,12.0,0,donta-thompson-1
282,Aaron Fuller*,Washington,Pac-12,13,59,702,11.9,6,0,0,,0,59,702,11.9,6,aaron-fuller-1
283,Kobe Smith*,San Diego State,MWC,13,58,691,11.9,4,0,0,,0,58,691,11.9,4,kobe-smith-2
284,Jonathan Hodoh,Louisiana-Monroe,Sun Belt,12,38,453,11.9,3,0,0,,0,38,453,11.9,3,jonathan-hodoh-1
285,Brandon Smith*,Iowa,Big Ten,9,37,439,11.9,5,0,0,,0,37,439,11.9,5,brandon-smith-11
286,Terrell Bynum*,Washington,Pac-12,13,31,368,11.9,2,1,9,9.0,0,32,377,11.8,2,terrell-bynum-1
287,Roger Carter*,Georgia State,Sun Belt,13,28,334,11.9,3,0,0,,0,28,334,11.9,3,roger-carter-2
288,Maurice Alexander*,Florida International,CUSA,10,25,298,11.9,1,9,42,4.7,0,34,340,10.0,1,maurice-alexander-2
289,Quintin Morris,Bowling Green State,MAC,12,55,649,11.8,4,0,0,,0,55,649,11.8,4,quintin-morris-1
290,Pat Freiermuth*,Penn State,Big Ten,13,43,507,11.8,7,0,0,,0,43,507,11.8,7,pat-freiermuth-1
291,Otis Anderson*,UCF,American,13,31,365,11.8,3,113,726,6.4,5,144,1091,7.6,8,otis-anderson-1
292,Albert Okwuegbunam,Missouri,SEC,11,26,306,11.8,6,0,0,,0,26,306,11.8,6,albert-okwuegbunam-1
293,Walter Fletcher,Ball State,MAC,12,26,306,11.8,2,132,726,5.5,5,158,1032,6.5,7,walter-fletcher-1
294,Taysir Mack*,Pitt,ACC,12,63,736,11.7,3,0,0,,0,63,736,11.7,3,taysir-mack-1
295,Travis Etienne*,Clemson,ACC,15,37,432,11.7,4,207,1614,7.8,19,244,2046,8.4,23,travis-etienne-1
296,Kendrick Rogers*,Texas A&M,SEC,13,30,351,11.7,2,0,0,,0,30,351,11.7,2,kendrick-rogers-1
297,Hassan Beydoun*,Eastern Michigan,MAC,13,30,349,11.6,1,2,-1,-0.5,0,32,348,10.9,1,hassan-beydoun-1
298,Lynn Bowden Jr.*,Kentucky,SEC,13,30,348,11.6,1,185,1468,7.9,13,215,1816,8.4,14,lynn-bowden-jr-1
299,Deshaunte Jones*,Iowa State,Big 12,13,76,877,11.5,2,4,3,0.8,0,80,880,11.0,2,deshaunte-jones-1
300,Bryan Edwards,South Carolina,SEC,10,71,816,11.5,6,2,22,11.0,0,73,838,11.5,6,bryan-edwards-1
301,Kirk Merritt*,Arkansas State,Sun Belt,13,70,806,11.5,12,2,11,5.5,0,72,817,11.3,12,kirk-merritt-1
302,Tyler Snead,East Carolina,American,12,66,759,11.5,5,4,27,6.8,0,70,786,11.2,5,tyler-snead-1
303,Dillon Stoner*,Oklahoma State,Big 12,13,52,599,11.5,5,1,12,12.0,0,53,611,11.5,5,dillon-stoner-1
304,Aleva Hifo*,Brigham Young,Ind,12,42,483,11.5,3,23,104,4.5,2,65,587,9.0,5,aleva-hifo-1
305,Easop Winston*,Washington State,Pac-12,13,85,970,11.4,11,0,0,,0,85,970,11.4,11,easop-winston-1
306,Kyle Philips,UCLA,Pac-12,12,60,681,11.4,5,1,7,7.0,0,61,688,11.3,5,kyle-philips-4
307,Quartney Davis*,Texas A&M,SEC,11,54,616,11.4,4,5,32,6.4,0,59,648,11.0,4,quartney-davis-1
308,Travell Harris*,Washington State,Pac-12,13,47,536,11.4,5,0,0,,0,47,536,11.4,5,travell-harris-1
309,Shi Smith,South Carolina,SEC,10,43,489,11.4,2,3,8,2.7,0,46,497,10.8,2,shi-smith-1
310,Ben Putman*,Nevada,MWC,13,26,297,11.4,0,1,4,4.0,0,27,301,11.1,0,ben-putman-1
311,Devin Gentry*,Georgia State,Sun Belt,13,25,286,11.4,2,3,24,8.0,0,28,310,11.1,2,devin-gentry-1
312,Kaylon Geiger,Troy,Sun Belt,12,77,873,11.3,5,4,36,9.0,1,81,909,11.2,6,kaylon-geiger-1
313,Zane Pope,Fresno State,MWC,12,47,529,11.3,1,1,0,0.0,0,48,529,11.0,1,zane-pope-1
314,Josh Johnson,Tulsa,American,12,44,495,11.3,1,0,0,,0,44,495,11.3,1,josh-johnson-9
315,Cee Jay Powell*,Louisiana Tech,CUSA,13,43,488,11.3,1,0,0,,0,43,488,11.3,1,cee-jay-powell-1
316,Wan'Dale Robinson,Nebraska,Big Ten,10,40,453,11.3,2,88,340,3.9,3,128,793,6.2,5,wandale-robinson-1
317,CJ O'Grady,Arkansas,SEC,7,33,372,11.3,3,1,3,3.0,0,34,375,11.0,3,cj-ogrady-1
318,Kyle Markway,South Carolina,SEC,12,31,349,11.3,2,0,0,,0,31,349,11.3,2,kyle-markway-1
319,Akilian Butler*,Boise State,MWC,14,28,316,11.3,2,8,54,6.8,1,36,370,10.3,3,akilian-butler-1
320,Xavier Gaines*,Marshall,CUSA,13,27,306,11.3,3,26,181,7.0,2,53,487,9.2,5,xavier-gaines-2
321,Najee Harris*,Alabama,SEC,13,27,304,11.3,7,209,1224,5.9,13,236,1528,6.5,20,najee-harris-1
322,Cedric Byrd*,Hawaii,MWC,15,98,1097,11.2,10,4,36,9.0,0,102,1133,11.1,10,cedric-byrd-1
323,Jadan Blue*,Temple,American,13,95,1067,11.2,4,6,20,3.3,0,101,1087,10.8,4,jadan-blue-1
324,Justin Hall,Ball State,MAC,12,61,684,11.2,6,24,187,7.8,2,85,871,10.2,8,justin-hall-3
325,K.J. Hill*,Ohio State,Big Ten,14,57,636,11.2,10,1,1,1.0,0,58,637,11.0,10,kj-hill-1
326,Ty Lee,Middle Tennessee State,CUSA,12,47,525,11.2,3,4,12,3.0,0,51,537,10.5,3,ty-lee-1
327,Justin Garrett,UTEP,CUSA,12,40,446,11.2,3,0,0,,0,40,446,11.2,3,justin-garrett-3
328,KeSean Carter,Texas Tech,Big 12,12,27,303,11.2,2,0,0,,0,27,303,11.2,2,kesean-carter-1
329,Chris Finke*,Notre Dame,Ind,13,41,456,11.1,4,2,2,1.0,0,43,458,10.7,4,chris-finke-1
330,Tyler Badie,Missouri,SEC,12,32,356,11.1,5,108,457,4.2,3,140,813,5.8,8,tyler-badie-1
331,Zak Simon,Massachusetts,Ind,11,32,355,11.1,2,0,0,,0,32,355,11.1,2,zak-simon-1
332,Amad Anderson Jr.,Purdue,Big Ten,12,31,343,11.1,3,0,0,,0,31,343,11.1,3,amad-anderson-jr-1
333,Demetris Robertson*,Georgia,SEC,13,30,333,11.1,3,6,52,8.7,0,36,385,10.7,3,demetris-robertson-1
334,Demetris Robertson*,Georgia,SEC,13,30,333,11.1,3,6,52,8.7,0,36,385,10.7,3,demetris-robertson-2
335,Tanner Cowley*,Virginia,ACC,14,28,311,11.1,1,0,0,,0,28,311,11.1,1,tanner-cowley-1
336,James Proche*,SMU,American,13,111,1225,11.0,15,4,18,4.5,0,115,1243,10.8,15,james-proche-1
337,Demari Simpkins*,Utah,Pac-12,14,32,352,11.0,2,8,43,5.4,1,40,395,9.9,3,demari-simpkins-1
338,Bret Clark,Troy,Sun Belt,11,29,319,11.0,3,0,0,,0,29,319,11.0,3,bret-clark-2
339,Sadiq Palmer,Massachusetts,Ind,12,25,275,11.0,2,0,0,,0,25,275,11.0,2,sadiq-palmer-1
340,Jake Smith*,Texas,Big 12,13,25,274,11.0,6,2,9,4.5,0,27,283,10.5,6,jake-smith-7
341,Kalil Pimpleton*,Central Michigan,MAC,14,82,894,10.9,6,7,81,11.6,0,89,975,11.0,6,kalil-pimpleton-1
342,Malik Williams*,Appalachian State,Sun Belt,14,55,598,10.9,4,5,16,3.2,0,60,614,10.2,4,malik-williams-2
343,K.J. Osborn*,Miami (FL),ACC,13,50,547,10.9,5,5,15,3.0,0,55,562,10.2,5,kj-osborn-1
344,Kalija Lipscomb,Vanderbilt,SEC,11,47,511,10.9,3,4,52,13.0,0,51,563,11.0,3,kalija-lipscomb-1
345,Tabari Hines,North Carolina State,ACC,12,37,402,10.9,2,3,53,17.7,0,40,455,11.4,2,tabari-hines-1
346,Tayvian Cunningham,Arizona,Pac-12,12,35,383,10.9,2,1,-1,-1.0,0,36,382,10.6,2,tayvian-cunningham-1
347,Matt Seybert*,Michigan State,Big Ten,12,26,284,10.9,3,0,0,,0,26,284,10.9,3,matt-seybert-1
348,Cornelius McCoy*,Georgia State,Sun Belt,13,70,757,10.8,5,1,4,4.0,0,71,761,10.7,5,cornelius-mccoy-1
349,Demetric Felton,UCLA,Pac-12,12,55,594,10.8,4,86,331,3.8,1,141,925,6.6,5,demetric-felton-1
350,Jaivon Heiligh,Coastal Carolina,Sun Belt,12,46,497,10.8,3,0,0,,0,46,497,10.8,3,jaivon-heiligh-1
351,Amare Jones*,Tulane,American,13,34,367,10.8,2,61,371,6.1,4,95,738,7.8,6,amare-jones-1
352,Cade Otton*,Washington,Pac-12,13,32,344,10.8,2,0,0,,0,32,344,10.8,2,cade-otton-1
353,Thayer Thomas,North Carolina State,ACC,12,31,334,10.8,3,0,0,,0,31,334,10.8,3,thayer-thomas-1
354,Andre Baccellia*,Washington,Pac-12,12,29,314,10.8,4,4,35,8.8,1,33,349,10.6,5,andre-baccellia-1
355,Dimitri Stanley,Colorado,Pac-12,12,29,312,10.8,2,4,14,3.5,0,33,326,9.9,2,dimitri-stanley-1
356,Tony Nicholson,New Mexico State,Ind,12,60,644,10.7,6,3,5,1.7,0,63,649,10.3,6,tony-nicholson-1
357,Renard Bell*,Washington State,Pac-12,13,54,579,10.7,6,0,0,,0,54,579,10.7,6,renard-bell-1
358,Kyle Williams*,Arizona State,Pac-12,13,45,482,10.7,2,13,46,3.5,0,58,528,9.1,2,kyle-williams-8
359,Anthony Schwartz*,Auburn,SEC,13,41,440,10.7,1,11,118,10.7,2,52,558,10.7,3,anthony-schwartz-1
360,Quin Jernighan*,Western Kentucky,CUSA,13,32,341,10.7,2,0,0,,0,32,341,10.7,2,quin-jernighan-1
361,Raheem Blackshear,Rutgers,Big Ten,4,29,310,10.7,2,29,88,3.0,0,58,398,6.9,2,raheem-blackshear-1
362,Tre'Shaun Harrison*,Florida State,ACC,12,27,289,10.7,2,4,10,2.5,0,31,299,9.6,2,treshaun-harrison-1
363,Jahcour Pearson*,Western Kentucky,CUSA,13,76,804,10.6,7,5,-12,-2.4,0,81,792,9.8,7,jahcour-pearson-1
364,Kavious Price*,Kent State,MAC,13,48,508,10.6,3,9,15,1.7,0,57,523,9.2,3,kavious-price-1
365,Jaylen Erwin,UCLA,Pac-12,12,32,339,10.6,2,0,0,,0,32,339,10.6,2,jaylen-erwin-1
366,Izaiah Lottie,New Mexico State,Ind,11,27,287,10.6,0,0,0,,0,27,287,10.6,0,izaiah-lottie-1
367,Jason-Matthew Sharsh*,Hawaii,MWC,15,87,913,10.5,5,3,13,4.3,0,90,926,10.3,5,jason-matthew-sharsh-1
368,Cam Johnson,Vanderbilt,SEC,12,30,316,10.5,3,0,0,,0,30,316,10.5,3,cam-johnson-2
369,Jordan Nathan*,Utah State,MWC,13,56,581,10.4,1,7,40,5.7,1,63,621,9.9,2,jordan-nathan-1
370,R.J. Sneed*,Baylor,Big 12,14,42,437,10.4,3,1,-5,-5.0,0,43,432,10.0,3,rj-sneed-1
371,Desmond Phillips,Toledo,MAC,12,36,376,10.4,2,0,0,,0,36,376,10.4,2,desmond-phillips-1
372,Kwamie Lassiter II,Kansas,Big 12,11,34,352,10.4,1,0,0,,0,34,352,10.4,1,kwamie-lassiter-ii-1
373,Kaleb Fossum*,Nevada,MWC,10,28,292,10.4,0,0,0,,0,28,292,10.4,0,kaleb-fossum-1
374,Brennon Dingle,Massachusetts,Ind,12,23,239,10.4,1,2,-5,-2.5,0,25,234,9.4,1,brennon-dingle-1
375,Emeka Emezie,North Carolina State,ACC,12,56,576,10.3,2,0,0,,0,56,576,10.3,2,emeka-emezie-1
376,De'Michael Harris*,Southern Mississippi,CUSA,12,34,346,10.2,3,113,541,4.8,5,147,887,6.0,8,demichael-harris-1
377,Jack Freudenthal*,Wake Forest,ACC,13,32,325,10.2,5,0,0,,0,32,325,10.2,5,jack-freudenthal-1
378,Jaylond Adams*,Southern Mississippi,CUSA,9,48,483,10.1,2,7,16,2.3,0,55,499,9.1,2,jaylond-adams-1
379,Jeremiah Haydel,Texas State,Sun Belt,11,32,324,10.1,0,0,0,,0,32,324,10.1,0,jeremiah-haydel-1
380,Johnathon Johnson,Missouri,SEC,8,29,294,10.1,0,1,13,13.0,0,30,307,10.2,0,johnathon-johnson-2
381,Samuel Emilus,Massachusetts,Ind,12,27,273,10.1,2,0,0,,0,27,273,10.1,2,samuel-emilus-1
382,Keith Mixon*,Western Michigan,MAC,13,50,500,10.0,2,1,47,47.0,1,51,547,10.7,3,keith-mixon-1
383,Garrett Groshek*,Wisconsin,Big Ten,14,29,289,10.0,0,42,194,4.6,2,71,483,6.8,2,garrett-groshek-1
384,DeJon Packer,San Jose State,MWC,12,27,270,10.0,1,125,567,4.5,11,152,837,5.5,12,dejon-packer-1
385,Connor Wedington,Stanford,Pac-12,11,51,506,9.9,1,3,30,10.0,0,54,536,9.9,1,connor-wedington-1
386,D.J. Matthews*,Florida State,ACC,12,36,355,9.9,3,4,18,4.5,0,40,373,9.3,3,dj-matthews-1
387,Ke'Shawn Vaughn,Vanderbilt,SEC,12,29,286,9.9,1,198,1028,5.2,9,227,1314,5.8,10,keshawn-vaughn-1
388,Bryson Denley,Bowling Green State,MAC,12,27,267,9.9,3,111,544,4.9,4,138,811,5.9,7,bryson-denley-1
389,Sam James,West Virginia,Big 12,12,69,677,9.8,2,4,19,4.8,0,73,696,9.5,2,sam-james-1
390,Antwan Dixon*,Kent State,MAC,13,34,333,9.8,1,5,-1,-0.2,0,39,332,8.5,1,antwan-dixon-2
391,Jaelon Darden,North Texas,CUSA,12,76,736,9.7,12,2,13,6.5,0,78,749,9.6,12,jaelon-darden-1
392,Jonathan Ward*,Central Michigan,MAC,12,34,329,9.7,1,183,1108,6.1,15,217,1437,6.6,16,jonathan-ward-3
393,Osiris St. Brown,Stanford,Pac-12,12,27,263,9.7,0,2,12,6.0,0,29,275,9.5,0,osiris-st-brown-1
394,Jay Rose,Connecticut,American,11,27,261,9.7,2,0,0,,0,27,261,9.7,2,jay-rose-1
395,Phillip Brooks*,Kansas State,Big 12,12,26,253,9.7,1,7,26,3.7,0,33,279,8.5,1,phillip-brooks-1
396,Nick Eubanks*,Michigan,Big Ten,13,25,243,9.7,4,0,0,,0,25,243,9.7,4,nick-eubanks-1
397,Jared Rice,Fresno State,MWC,12,32,307,9.6,4,0,0,,0,32,307,9.6,4,jared-rice-1
398,Myron Gailliard*,SMU,American,11,26,250,9.6,1,0,0,,0,26,250,9.6,1,myron-gailliard-1
399,Cameron Scarlett,Stanford,Pac-12,12,25,240,9.6,0,201,840,4.2,7,226,1080,4.8,7,cameron-scarlett-1
400,Brady Russell,Colorado,Pac-12,12,23,221,9.6,2,0,0,,0,23,221,9.6,2,brady-russell-1
401,Nico Ragaini*,Iowa,Big Ten,13,46,439,9.5,2,1,2,2.0,0,47,441,9.4,2,nico-ragaini-1
402,McLane Mannix,Texas Tech,Big 12,12,26,248,9.5,3,3,37,12.3,0,29,285,9.8,3,mclane-mannix-1
403,Isaiah Wright*,Temple,American,12,47,442,9.4,5,5,48,9.6,0,52,490,9.4,5,isaiah-wright-1
404,Brandon Bowling*,Arkansas State,Sun Belt,13,28,263,9.4,2,0,0,,0,28,263,9.4,2,brandon-bowling-1
405,Jack Stoll,Nebraska,Big Ten,12,25,234,9.4,1,0,0,,0,25,234,9.4,1,jack-stoll-1
406,Jaylon Redd*,Oregon,Pac-12,12,50,465,9.3,7,6,10,1.7,2,56,475,8.5,9,jaylon-redd-1
407,Rontavious Groves*,North Carolina,ACC,13,27,250,9.3,1,3,11,3.7,0,30,261,8.7,1,rontavious-groves-1
408,Rontavius Groves*,North Carolina,ACC,13,27,250,9.3,1,3,11,3.7,0,30,261,8.7,1,rontavius-groves-1
409,Hutch White,Texas State,Sun Belt,12,67,618,9.2,2,3,-3,-1.0,0,70,615,8.8,2,hutch-white-1
410,Noah Togiai,Oregon State,Pac-12,12,44,406,9.2,3,0,0,,0,44,406,9.2,3,noah-togiai-1
411,Jackson Anthrop,Purdue,Big Ten,12,37,340,9.2,1,12,48,4.0,0,49,388,7.9,1,jackson-anthrop-1
412,Dominic Christian*,Nevada,MWC,12,35,321,9.2,2,1,-9,-9.0,0,36,312,8.7,2,dominic-christian-1
413,Jalon Calhoun,Duke,ACC,12,46,420,9.1,4,4,2,0.5,0,50,422,8.4,4,jalon-calhoun-1
414,Barrett Banister,Missouri,SEC,11,27,246,9.1,1,0,0,,0,27,246,9.1,1,barrett-banister-1
415,Dylan Drummond*,Eastern Michigan,MAC,13,55,493,9.0,3,4,23,5.8,0,59,516,8.7,3,dylan-drummond-1
416,John Raine*,Florida Atlantic,CUSA,14,38,343,9.0,6,0,0,,0,38,343,9.0,6,john-raine-1
417,J.J. Taylor,Arizona,Pac-12,11,32,289,9.0,0,148,721,4.9,5,180,1010,5.6,5,jj-taylor-1
418,Maurice Ffrench*,Pitt,ACC,11,96,850,8.9,4,9,22,2.4,0,105,872,8.3,4,maurice-ffrench-1
419,Aaron Hackett,Syracuse,ACC,12,23,205,8.9,6,1,3,3.0,0,24,208,8.7,6,aaron-hackett-1
420,Joe Reed*,Virginia,ACC,13,77,679,8.8,7,8,42,5.3,0,85,721,8.5,7,joe-reed-4
421,Brian Casteel,Arizona,Pac-12,12,45,397,8.8,3,4,22,5.5,0,49,419,8.6,3,brian-casteel-1
422,Ky'Jon Tyler,Coastal Carolina,Sun Belt,9,23,203,8.8,1,4,-16,-4.0,0,27,187,6.9,1,kyjon-tyler-1
423,Eli Stove*,Auburn,SEC,13,37,321,8.7,3,7,57,8.1,1,44,378,8.6,4,eli-stove-1
424,Jacquez Sloan*,Western Kentucky,CUSA,13,34,297,8.7,1,8,80,10.0,2,42,377,9.0,3,jacquez-sloan-1
425,Riley Lees,Northwestern,Big Ten,12,51,430,8.4,2,3,6,2.0,0,54,436,8.1,2,riley-lees-1
426,Sheldon Jones,UTSA,CUSA,12,31,259,8.4,0,1,-4,-4.0,0,32,255,8.0,0,sheldon-jones-1
427,DK Billingsley,Troy,Sun Belt,12,25,211,8.4,0,155,901,5.8,10,180,1112,6.2,10,dk-billingsley-1
428,Eno Benjamin*,Arizona State,Pac-12,12,42,347,8.3,2,253,1083,4.3,10,295,1430,4.8,12,eno-benjamin-1
429,Billy Kemp*,Virginia,ACC,13,35,289,8.3,1,2,7,3.5,0,37,296,8.0,1,billy-kemp-2
430,Danny Davis*,Wisconsin,Big Ten,14,30,250,8.3,1,9,110,12.2,1,39,360,9.2,2,danny-davis-5
431,Keaontay Ingram*,Texas,Big 12,13,29,242,8.3,3,144,853,5.9,7,173,1095,6.3,10,keaontay-ingram-1
432,Moe Neal,Syracuse,ACC,12,29,242,8.3,0,170,846,5.0,7,199,1088,5.5,7,moe-neal-1
433,Clyde Edwards-Helaire*,LSU,SEC,15,55,453,8.2,1,215,1414,6.6,16,270,1867,6.9,17,clyde-edwards-helaire-1
434,Ronnie Rivers,Fresno State,MWC,12,43,348,8.1,3,177,899,5.1,13,220,1247,5.7,16,ronnie-rivers-1
435,Stevie Scott*,Indiana,Big Ten,11,26,211,8.1,1,178,845,4.7,10,204,1056,5.2,11,stevie-scott-1
436,Sincere McCormick,UTSA,CUSA,12,24,194,8.1,1,177,983,5.6,8,201,1177,5.9,9,sincere-mccormick-1
437,OJ Clark,New Mexico State,Ind,12,58,457,7.9,1,0,0,,0,58,457,7.9,1,oj-clark-1
438,Pooka Williams,Kansas,Big 12,11,27,214,7.9,2,203,1061,5.2,3,230,1275,5.5,5,pooka-williams-1
439,C.J. Marable,Coastal Carolina,Sun Belt,12,38,295,7.8,3,204,1085,5.3,11,242,1380,5.7,14,torrance-marable-1
440,Michael Mathison,Akron,MAC,10,31,243,7.8,0,2,10,5.0,0,33,253,7.7,0,michael-mathison-1
441,Noah Gray,Duke,ACC,12,51,392,7.7,3,0,0,,0,51,392,7.7,3,noah-gray-1
442,Sean Riley,Syracuse,ACC,12,36,275,7.6,1,5,7,1.4,0,41,282,6.9,1,sean-riley-2
443,Landon Wolf*,Oklahoma State,Big 12,13,25,189,7.6,0,0,0,,0,25,189,7.6,0,landon-wolf-1
444,Cam Akers*,Florida State,ACC,11,30,225,7.5,4,231,1144,5.0,14,261,1369,5.2,18,cam-akers-1
445,Smoke Harris*,Louisiana Tech,CUSA,13,47,348,7.4,2,11,61,5.5,1,58,409,7.1,3,smoke-harris-1
446,Jermaine Johnson Jr.,Massachusetts,Ind,12,37,272,7.4,2,4,37,9.3,0,41,309,7.5,2,jermaine-johnson-jr-1
447,Kesean Strong,Old Dominion,CUSA,11,27,200,7.4,0,84,353,4.2,4,111,553,5.0,4,kesean-strong-1
448,Art Pierce,Oregon State,Pac-12,12,23,169,7.3,1,146,873,6.0,6,169,1042,6.2,7,art-pierce-1
449,Isaiah Spiller*,Texas A&M,SEC,13,29,203,7.0,0,174,946,5.4,10,203,1149,5.7,10,isaiah-spiller-1
450,Max Borghi*,Washington State,Pac-12,13,86,597,6.9,5,127,817,6.4,11,213,1414,6.6,16,max-borghi-1
451,Lamical Perine*,Florida,SEC,13,40,262,6.6,5,132,676,5.1,6,172,938,5.5,11,lamical-perine-1
452,Art Thompkins,Connecticut,American,12,39,257,6.6,2,98,468,4.8,2,137,725,5.3,4,art-thompkins-1
453,Gerold Bright*,Utah State,MWC,13,35,230,6.6,1,182,921,5.1,9,217,1151,5.3,10,gerold-bright-1
454,Julian Hicks,Akron,MAC,10,32,212,6.6,2,1,1,1.0,0,33,213,6.5,2,julian-hicks-1
455,Tra Minter,South Alabama,Sun Belt,12,32,209,6.5,0,193,1057,5.5,5,225,1266,5.6,5,tra-minter-1
456,Toa Taua*,Nevada,MWC,13,30,185,6.2,0,196,807,4.1,6,226,992,4.4,6,toa-taua-1
457,Caleb Twyford,Texas State,Sun Belt,11,27,145,5.4,1,108,488,4.5,2,135,633,4.7,3,caleb-twyford-1
458,Caleb Twyford,Texas State,Sun Belt,11,27,145,5.4,1,108,488,4.5,2,135,633,4.7,3,caleb-twyford-2
459,Jason Huntley,New Mexico State,Ind,12,40,192,4.8,2,154,1090,7.1,9,194,1282,6.6,11,jason-huntley-1
460,Sewo Olonilua,TCU,Big 12,12,24,114,4.8,1,134,537,4.0,8,158,651,4.1,9,sewo-olonilua-1
461,Kennedy McKoy,West Virginia,Big 12,12,37,167,4.5,1,99,323,3.3,3,136,490,3.6,4,kennedy-mckoy-1
462,Alex Fontenot,Colorado,Pac-12,11,27,122,4.5,0,185,874,4.7,5,212,996,4.7,5,alex-fontenot-1
463,SaRodorick Thompson,Texas Tech,Big 12,12,39,154,3.9,0,160,765,4.8,12,199,919,4.6,12,sarodorick-thompson-1