Rk,Player,School,Conf,G,Rec,Yds,Avg,TD,Att,Yds,Avg,TD,Plays,Yds,Avg,TD,-9999
1,Chris Lewis*,Troy,Sun Belt,14,32,735,23.0,10,1,1,1.0,0,33,736,22.3,10,chris-lewis-7
2,Javon Baker*,UCF,Big 12,13,52,1139,21.9,7,0,0,,0,52,1139,21.9,7,javon-baker-1
3,Kelly Akharaiyi,UTEP,CUSA,12,48,1033,21.5,7,1,7,7.0,0,49,1040,21.2,7,kelly-akharaiyi-1
4,Nic Anderson*,Oklahoma,Big 12,13,38,798,21.0,10,0,0,,0,38,798,21.0,10,nic-anderson-1
5,Kobe Hudson*,UCF,Big 12,13,44,900,20.5,8,1,-8,-8.0,0,45,892,19.8,8,kobe-hudson-1
6,Jermaine Burton*,Alabama,SEC,13,39,798,20.5,8,0,0,,0,39,798,20.5,8,jermaine-burton-1
7,Quentin Skinner*,Kansas,Big 12,13,29,587,20.2,2,2,8,4.0,0,31,595,19.2,2,quentin-skinner-2
8,Reggie Brown*,James Madison,Sun Belt,13,53,1054,19.9,9,0,0,,0,53,1054,19.9,9,reggie-brown-12
9,Jeff Foreman*,Arkansas State,Sun Belt,13,29,573,19.8,4,0,0,,0,29,573,19.8,4,jeff-foreman-1
10,Corey Rucker*,Arkansas State,Sun Belt,13,36,705,19.6,2,1,6,6.0,0,37,711,19.2,2,corey-rucker-1
11,Darrell Harding Jr.,Buffalo,MAC,12,23,451,19.6,3,0,0,,0,23,451,19.6,3,darrell-harding-jr-1
12,CJ Daniels*,Liberty,CUSA,14,55,1067,19.4,10,0,0,,0,55,1067,19.4,10,cj-daniels-1
13,Dalevon Campbell,Nevada,MWC,12,31,594,19.2,2,1,-1,-1.0,0,32,593,18.5,2,dalevon-campbell-1
14,Jakarius Caston,Southern Mississippi,Sun Belt,12,33,621,18.8,6,4,32,8.0,1,37,653,17.6,7,jakarius-caston-1
15,Eric McAlister*,Boise State,MWC,9,47,873,18.6,5,0,0,,0,47,873,18.6,5,eric-mcalister-1
16,Kyren Lacy*,LSU,SEC,13,30,558,18.6,7,0,0,,0,30,558,18.6,7,kyren-lacy-1
17,Devin Carter*,West Virginia,Big 12,12,27,501,18.6,2,0,0,,0,27,501,18.6,2,devin-carter-2
18,Chris Tyree*,Notre Dame,Ind,12,26,484,18.6,3,3,-1,-0.3,0,29,483,16.7,3,chris-tyree-1
19,Jayden Higgins*,Iowa State,Big 12,13,53,983,18.5,6,0,0,,0,53,983,18.5,6,jayden-higgins-1
20,Damien Alford*,Syracuse,ACC,13,33,610,18.5,3,0,0,,0,33,610,18.5,3,damien-alford-1
21,Caleb Medford,New Mexico,MWC,12,30,551,18.4,2,0,0,,0,30,551,18.4,2,caleb-medford-1
22,Tejhaun Palmer,UAB,American,12,47,858,18.3,7,0,0,,0,47,858,18.3,7,tejhaun-palmer-1
23,Ramel Keyton*,Tennessee,SEC,13,35,642,18.3,6,0,0,,0,35,642,18.3,6,ramel-keyton-1
24,Tre Harris*,Ole Miss,SEC,12,54,985,18.2,8,0,0,,0,54,985,18.2,8,tre-harris-1
25,Lawrence Keys III*,Tulane,American,10,33,599,18.2,7,4,25,6.3,0,37,624,16.9,7,lawrence-keys-iii-1
26,Marvin Harrison Jr.*,Ohio State,Big Ten,12,67,1211,18.1,14,2,26,13.0,1,69,1237,17.9,15,marvin-harrison-jr-1
27,Jarius Mack,Charlotte,American,11,25,453,18.1,2,2,-8,-4.0,0,27,445,16.5,2,jarius-mack-1
28,Tahj Washington*,USC,Pac-12,13,59,1062,18.0,8,1,10,10.0,0,60,1072,17.9,8,tahj-washington-1
29,Reymello Murphy*,Old Dominion,Sun Belt,13,28,502,17.9,3,0,0,,0,28,502,17.9,3,reymello-murphy-1
30,Rome Odunze*,Washington,Pac-12,15,92,1640,17.8,13,2,37,18.5,1,94,1677,17.8,14,rome-odunze-1
31,Lawrence Arnold*,Kansas,Big 12,13,44,782,17.8,6,1,10,10.0,0,45,792,17.6,6,lawrence-arnold-2
32,Chris Parker,Central Michigan,MAC,12,23,409,17.8,3,0,0,,0,23,409,17.8,3,chris-parker-5
33,Xavier Legette,South Carolina,SEC,12,71,1255,17.7,7,9,-9,-1.0,0,80,1246,15.6,7,xavier-legette-1
34,Courtney Jackson*,Arkansas State,Sun Belt,13,39,689,17.7,7,1,5,5.0,0,40,694,17.4,7,courtney-jackson-2
35,Perry Carter*,Jacksonville State,CUSA,13,38,672,17.7,4,6,40,6.7,0,44,712,16.2,4,perry-carter-2
36,Malik Nabers*,LSU,SEC,13,89,1569,17.6,14,1,1,1.0,0,90,1570,17.4,14,malik-nabers-1
37,Jay Maclin,North Texas,American,12,57,1004,17.6,11,0,0,,0,57,1004,17.6,11,jay-maclin-1
38,Brenden Rice*,USC,Pac-12,12,45,791,17.6,12,0,0,,0,45,791,17.6,12,brenden-rice-1
39,Bub Means,Pitt,ACC,12,41,721,17.6,6,0,0,,0,41,721,17.6,6,bub-means-1
40,Da'Quan Felton*,Virginia Tech,ACC,13,38,667,17.6,8,0,0,,0,38,667,17.6,8,daquan-felton-1
41,Kris Mitchell,Florida International,CUSA,12,64,1118,17.5,6,1,0,0.0,0,65,1118,17.2,6,kris-mitchell-1
42,Amad Anderson Jr.,Temple,American,11,37,647,17.5,3,2,-6,-3.0,0,39,641,16.4,3,amad-anderson-jr-1
43,Ketron Jackson Jr.,Baylor,Big 12,10,28,489,17.5,1,1,3,3.0,0,29,492,17.0,1,ketron-jackson-jr-1
44,Micah Davis*,Utah State,MWC,11,36,628,17.4,6,0,0,,0,36,628,17.4,6,micah-davis-1
45,Tykee Ogle-Kellogg*,UTSA,American,13,33,575,17.4,7,0,0,,0,33,575,17.4,7,tykee-ogle-kellogg-1
46,Brian Thomas Jr.*,LSU,SEC,13,68,1177,17.3,17,1,-6,-6.0,0,69,1171,17.0,17,brian-thomas-jr-1
47,Kelby Williams*,Old Dominion,Sun Belt,12,26,451,17.3,2,1,0,0.0,0,27,451,16.7,2,kelby-williams-1
48,Troy Franklin*,Oregon,Pac-12,13,81,1383,17.1,14,0,0,,0,81,1383,17.1,14,troy-franklin-2
49,Demeer Blankumsee*,Memphis,American,13,53,901,17.0,7,2,15,7.5,0,55,916,16.7,7,demeer-blankumsee-1
50,Devontez Walker*,North Carolina,ACC,8,41,699,17.0,7,3,23,7.7,0,44,722,16.4,7,devontez-walker-1
51,Ricky White*,UNLV,MWC,14,88,1483,16.9,8,1,1,1.0,0,89,1484,16.7,8,ricky-white-2
52,Cyrus Allen,Louisiana Tech,CUSA,11,46,778,16.9,4,2,-8,-4.0,0,48,770,16.0,4,cyrus-allen-1
53,Jahdae Walker*,Texas A&M,SEC,13,35,590,16.9,2,0,0,,0,35,590,16.9,2,jahdae-walker-1
54,Ja'lynn Polk*,Washington,Pac-12,15,69,1159,16.8,9,4,32,8.0,1,73,1191,16.3,10,jalynn-polk-1
55,Luke Grimm*,Kansas,Big 12,13,33,555,16.8,6,1,-6,-6.0,0,34,549,16.1,6,luke-grimm-1
56,Drake Dabney,Baylor,Big 12,12,33,552,16.7,5,0,0,,0,33,552,16.7,5,drake-dabney-1
57,Mason Fairchild*,Kansas,Big 12,13,27,451,16.7,3,0,0,,0,27,451,16.7,3,mason-fairchild-1
58,Dariyan Wiley,Louisiana-Monroe,Sun Belt,12,24,400,16.7,2,0,0,,0,24,400,16.7,2,dariyan-wiley-1
59,J. Michael Sturdivant*,UCLA,Pac-12,13,36,597,16.6,4,0,0,,0,36,597,16.6,4,j-michael-sturdivant-1
60,Roman Wilson*,Michigan,Big Ten,15,48,789,16.4,12,1,10,10.0,0,49,799,16.3,12,roman-wilson-1
61,Monaray Baldwin,Baylor,Big 12,12,38,623,16.4,4,3,17,5.7,0,41,640,15.6,4,monaray-baldwin-1
62,Steven McBride,Hawaii,MWC,13,63,1024,16.3,9,0,0,,0,63,1024,16.3,9,steven-mcbride-1
63,Elic Ayomanor,Stanford,Pac-12,12,62,1013,16.3,6,0,0,,0,62,1013,16.3,6,elic-ayomanor-1
64,Anthony Gould*,Oregon State,Pac-12,11,44,718,16.3,2,4,22,5.5,0,48,740,15.4,2,anthony-gould-1
65,Naiem Simmons*,South Florida,American,13,39,637,16.3,5,0,0,,0,39,637,16.3,5,naiem-simmons-1
66,Leon Johnson III*,Oklahoma State,Big 12,10,33,539,16.3,1,0,0,,0,33,539,16.3,1,leon-johnson-iii-1
67,Chris Brazzell II*,Tulane,American,13,44,711,16.2,5,0,0,,0,44,711,16.2,5,chris-brazzell-ii-1
68,Gage Larvadain*,Miami (OH),MAC,10,42,679,16.2,6,5,59,11.8,0,47,738,15.7,6,gage-larvadain-1
69,Jeremiah Ballard,UTEP,CUSA,12,34,551,16.2,1,0,0,,0,34,551,16.2,1,jeremiah-ballard-1
70,Jayce Brown*,Kansas State,Big 12,10,27,437,16.2,3,4,3,0.8,0,31,440,14.2,3,jayce-brown-1
71,Justus Ross-Simmons,Colorado State,MWC,12,45,724,16.1,3,0,0,,0,45,724,16.1,3,justus-ross-simmons-1
72,Khafre Brown*,South Florida,American,12,27,435,16.1,5,0,0,,0,27,435,16.1,5,khafre-brown-1
73,Blair Conwright,North Texas,American,12,24,385,16.0,2,0,0,,0,24,385,16.0,2,blair-conwright-1
74,Ashtyn Hawkins*,Texas State,Sun Belt,13,55,874,15.9,3,1,-2,-2.0,0,56,872,15.6,3,ashtyn-hawkins-1
75,Kaden Prather*,Maryland,Big Ten,13,42,666,15.9,5,1,36,36.0,0,43,702,16.3,5,kaden-prather-1
76,Jonathan Brady*,New Mexico State,CUSA,15,39,621,15.9,4,9,35,3.9,1,48,656,13.7,5,jonathan-brady-1
77,Trent Hudson*,New Mexico State,CUSA,14,36,571,15.9,10,1,10,10.0,0,37,581,15.7,10,trent-hudson-1
78,Ladd McConkey*,Georgia,SEC,9,30,478,15.9,2,2,38,19.0,1,32,516,16.1,3,ladd-mcconkey-1
79,Andrel Anthony*,Oklahoma,Big 12,6,27,429,15.9,1,0,0,,0,27,429,15.9,1,andrel-anthony-1
80,Roc Taylor*,Memphis,American,13,69,1083,15.7,4,2,2,1.0,0,71,1085,15.3,4,roc-taylor-1
81,Christian Horn*,Appalachian State,Sun Belt,14,36,566,15.7,6,0,0,,0,36,566,15.7,6,christian-horn-1
82,Marcus Rosemy-Jacksaint*,Georgia,SEC,13,34,535,15.7,4,0,0,,0,34,535,15.7,4,marcus-rosemy-jacksaint-1
83,Tetairoa McMillan*,Arizona,Pac-12,13,90,1402,15.6,10,1,3,3.0,0,91,1405,15.4,10,tetairoa-mcmillan-1
84,Peter LeBlanc*,Louisiana,Sun Belt,13,30,468,15.6,4,0,0,,0,30,468,15.6,4,peter-leblanc-1
85,Jamaal Pritchett*,South Alabama,Sun Belt,13,57,883,15.5,8,0,0,,0,57,883,15.5,8,jamaal-pritchett-1
86,Kamdyn Benjamin,Tulsa,American,12,47,727,15.5,6,1,8,8.0,0,48,735,15.3,6,kamdyn-benjamin-1
87,J.J. Jones*,North Carolina,ACC,13,46,711,15.5,3,0,0,,0,46,711,15.5,3,jj-jones-5
88,Makai Jackson*,Appalachian State,Sun Belt,14,27,418,15.5,2,0,0,,0,27,418,15.5,2,makai-jackson-1
89,Adonai Mitchell*,Texas,Big 12,14,55,845,15.4,11,2,1,0.5,0,57,846,14.8,11,adonai-mitchell-1
90,Jalil Farooq*,Oklahoma,Big 12,13,45,694,15.4,2,17,95,5.6,0,62,789,12.7,2,jalil-farooq-1
91,Romello Brinson*,SMU,American,14,28,431,15.4,2,0,0,,0,28,431,15.4,2,romello-brinson-1
92,Trey Cleveland,North Texas,American,12,27,415,15.4,3,0,0,,0,27,415,15.4,3,trey-cleveland-1
93,Tyson Davis,Central Michigan,MAC,10,29,444,15.3,4,0,0,,0,29,444,15.3,4,tyson-davis-1
94,Trell Harris,Kent State,MAC,11,26,399,15.3,1,0,0,,0,26,399,15.3,1,trell-harris-1
95,Jalen Royals*,Utah State,MWC,13,71,1080,15.2,15,0,0,,0,71,1080,15.2,15,jalen-royals-1
96,Jacolby George*,Miami (FL),ACC,13,57,864,15.2,8,1,14,14.0,1,58,878,15.1,9,jacolby-george-1
97,Nick Nash*,San Jose State,MWC,13,48,728,15.2,8,1,0,0.0,0,49,728,14.9,8,nick-nash-1
98,Holden Willis,Middle Tennessee State,CUSA,11,46,697,15.2,5,0,0,,0,46,697,15.2,5,holden-willis-1
99,Ja'Tavion Sanders*,Texas,Big 12,14,45,682,15.2,2,1,12,12.0,0,46,694,15.1,2,jatavion-sanders-1
100,RJ Maryland*,SMU,American,14,34,518,15.2,7,0,0,,0,34,518,15.2,7,rj-maryland-1
101,Josh Kelly,Washington State,Pac-12,12,61,923,15.1,8,1,3,3.0,0,62,926,14.9,8,josh-kelly-2
102,Dayton Wade*,Ole Miss,SEC,13,55,830,15.1,4,7,25,3.6,0,62,855,13.8,4,dayton-wade-1
103,Tai Felton*,Maryland,Big Ten,13,48,723,15.1,6,1,16,16.0,0,49,739,15.1,6,tai-felton-1
104,Dane Key*,Kentucky,SEC,13,42,636,15.1,6,0,0,,0,42,636,15.1,6,dane-key-1
105,Trond Grizzell*,California,Pac-12,13,39,590,15.1,5,0,0,,0,39,590,15.1,5,trond-grizzell-1
106,Umari Hatcher*,Syracuse,ACC,13,32,482,15.1,3,0,0,,0,32,482,15.1,3,umari-hatcher-1
107,Jack Velling*,Oregon State,Pac-12,12,29,438,15.1,8,0,0,,0,29,438,15.1,8,jack-velling-1
108,Dean Patterson,Florida International,CUSA,12,28,423,15.1,1,1,1,1.0,0,29,424,14.6,1,dean-patterson-1
109,Ainias Smith*,Texas A&M,SEC,12,53,795,15.0,2,5,21,4.2,0,58,816,14.1,2,ainias-smith-1
110,Johnny Wilson*,Florida State,ACC,10,41,617,15.0,2,0,0,,0,41,617,15.0,2,johnny-wilson-3
111,Taylor Morin,Wake Forest,ACC,12,41,617,15.0,2,1,2,2.0,0,42,619,14.7,2,taylor-morin-1
112,Dalen Cobb*,Georgia Southern,Sun Belt,12,40,601,15.0,2,7,51,7.3,0,47,652,13.9,2,dalen-cobb-1
113,Bryson Green*,Wisconsin,Big Ten,11,32,480,15.0,2,0,0,,0,32,480,15.0,2,bryson-green-1
114,Caden Prieskorn*,Ole Miss,SEC,10,30,449,15.0,4,0,0,,0,30,449,15.0,4,caden-prieskorn-1
115,Eric Singleton Jr.*,Georgia Tech,ACC,12,48,714,14.9,6,1,9,9.0,0,49,723,14.8,6,eric-singleton-jr-1
116,Chrishon McCray,Kent State,MAC,9,41,610,14.9,4,4,22,5.5,0,45,632,14.0,4,chrishon-mccray-1
117,Ricky Pearsall,Florida,SEC,12,65,965,14.8,4,3,62,20.7,2,68,1027,15.1,6,ricky-pearsall-1
118,Gary Bryant Jr.*,Oregon,Pac-12,14,30,442,14.7,4,3,18,6.0,0,33,460,13.9,4,gary-bryant-jr-1
119,Will Sheppard,Vanderbilt,SEC,12,47,684,14.6,8,0,0,,0,47,684,14.6,8,will-sheppard-1
120,Mitchell Evans*,Notre Dame,Ind,8,29,422,14.6,1,1,2,2.0,0,30,424,14.1,1,mitchell-evans-2
121,Jayden Harrison*,Marshall,Sun Belt,13,28,410,14.6,1,1,8,8.0,0,29,418,14.4,1,jayden-harrison-1
122,Dequece Carter,Indiana,Big Ten,12,27,395,14.6,3,1,1,1.0,0,28,396,14.1,3,dequece-carter-1
123,Landon Ransom-Goelz*,Rice,American,13,26,380,14.6,3,0,0,,0,26,380,14.6,3,landon-ransom-goelz-1
124,Rawson MacNeill*,Rice,American,13,26,379,14.6,2,0,0,,0,26,379,14.6,2,rawson-macneill-1
125,Caullin Lacy*,South Alabama,Sun Belt,12,91,1316,14.5,7,0,0,,0,91,1316,14.5,7,caullin-lacy-1
126,Elijah Sarratt*,James Madison,Sun Belt,13,82,1191,14.5,8,1,1,1.0,1,83,1192,14.4,9,elijah-sarratt-1
127,Rico Flores Jr.*,Notre Dame,Ind,12,27,392,14.5,1,0,0,,0,27,392,14.5,1,rico-flores-jr-1
128,Colston Loveland*,Michigan,Big Ten,15,45,649,14.4,4,0,0,,0,45,649,14.4,4,colston-loveland-1
129,Sam Pinckney*,Coastal Carolina,Sun Belt,13,72,1027,14.3,8,1,7,7.0,0,73,1034,14.2,8,sam-pinckney-1
130,Bryce Kirtz*,Northwestern,Big Ten,12,49,701,14.3,5,0,0,,0,49,701,14.3,5,bryce-kirtz-1
131,Bryson Nesbit*,North Carolina,ACC,12,41,585,14.3,5,0,0,,0,41,585,14.3,5,bryson-nesbit-1
132,Xavier White*,Texas Tech,Big 12,13,39,556,14.3,1,4,3,0.8,0,43,559,13.0,1,xavier-white-1
133,Rashod Owens*,Oklahoma State,Big 12,14,63,895,14.2,5,0,0,,0,63,895,14.2,5,rashod-owens-1
134,Harold Fannin Jr.*,Bowling Green State,MAC,11,44,623,14.2,6,14,41,2.9,0,58,664,11.4,6,harold-fannin-jr-1
135,Jordan Hudson*,SMU,American,14,30,425,14.2,7,0,0,,0,30,425,14.2,7,jordan-hudson-1
136,Preston Fox*,West Virginia,Big 12,12,26,368,14.2,2,1,3,3.0,0,27,371,13.7,2,preston-fox-1
137,Luther Burden*,Missouri,SEC,13,86,1212,14.1,9,7,31,4.4,0,93,1243,13.4,9,luther-burden-1
138,Daniel Jackson*,Minnesota,Big Ten,13,59,831,14.1,8,1,-5,-5.0,0,60,826,13.8,8,daniel-jackson-5
139,Jeshaun Jones*,Maryland,Big Ten,13,56,790,14.1,4,1,-1,-1.0,0,57,789,13.8,4,jeshaun-jones-1
140,Junior Vandeross III*,Toledo,MAC,14,47,664,14.1,4,3,38,12.7,0,50,702,14.0,4,junior-vandeross-iii-1
141,Jesse Prewitt III,Central Michigan,MAC,12,31,438,14.1,4,0,0,,0,31,438,14.1,4,jesse-prewitt-iii-1
142,Luke McCaffrey*,Rice,American,13,71,992,14.0,13,15,117,7.8,0,86,1109,12.9,13,luke-mccaffrey-1
143,Malachi Fields,Virginia,ACC,12,58,811,14.0,5,1,-6,-6.0,0,59,805,13.6,5,malachi-fields-1
144,Jordan Watkins*,Ole Miss,SEC,13,53,741,14.0,3,1,-9,-9.0,0,54,732,13.6,3,jordan-watkins-2
145,Cade Stover*,Ohio State,Big Ten,12,41,576,14.0,5,0,0,,0,41,576,14.0,5,cade-stover-1
146,Savion Williams,TCU,Big 12,11,41,573,14.0,4,11,62,5.6,0,52,635,12.2,4,savion-williams-2
147,Chris Bell*,Louisville,ACC,14,29,407,14.0,2,0,0,,0,29,407,14.0,2,chris-bell-2
148,Anthony Simpson,Massachusetts,Ind,12,57,792,13.9,3,11,93,8.5,1,68,885,13.0,4,anthony-simpson-2
149,Theo Wease*,Missouri,SEC,13,49,682,13.9,6,0,0,,0,49,682,13.9,6,theo-wease-1
150,Isaiah Bond*,Alabama,SEC,14,48,668,13.9,4,1,3,3.0,0,49,671,13.7,4,isaiah-bond-1
151,Kyle Williams,Washington State,Pac-12,12,61,843,13.8,6,3,-10,-3.3,0,64,833,13.0,6,kyle-williams-11
152,Silas Bolden*,Oregon State,Pac-12,13,54,746,13.8,5,9,84,9.3,2,63,830,13.2,7,silas-bolden-1
153,Ben Sinnott*,Kansas State,Big 12,12,49,676,13.8,6,0,0,,0,49,676,13.8,6,ben-sinnott-1
154,Devaughn Vele*,Utah,Pac-12,10,43,593,13.8,3,0,0,,0,43,593,13.8,3,devaughn-vele-1
155,Latreal Jones,Southern Mississippi,Sun Belt,12,36,498,13.8,3,0,0,,0,36,498,13.8,3,latreal-jones-1
156,Devan Williams,Tulsa,American,9,29,399,13.8,2,1,0,0.0,0,30,399,13.3,2,devan-williams-1
157,Joe Griffin*,Boston College,ACC,12,25,345,13.8,1,0,0,,0,25,345,13.8,1,joe-griffin-3
158,Tez Johnson*,Oregon,Pac-12,14,86,1182,13.7,10,0,0,,0,86,1182,13.7,10,tez-johnson-1
159,Casey Washington,Illinois,Big Ten,12,49,670,13.7,4,0,0,,0,49,670,13.7,4,casey-washington-1
160,Billy Bowens*,Boise State,MWC,14,28,383,13.7,1,0,0,,0,28,383,13.7,1,billy-bowens-1
161,Jamari Thrash*,Louisville,ACC,12,63,858,13.6,6,1,12,12.0,1,64,870,13.6,7,jamari-thrash-1
162,Andrew Armstrong,Arkansas,SEC,12,56,764,13.6,5,1,3,3.0,0,57,767,13.5,5,andrew-armstrong-2
163,Chase Roberts,Brigham Young,Big 12,12,42,573,13.6,5,2,12,6.0,0,44,585,13.3,5,chase-roberts-2
164,Xavier Worthy*,Texas,Big 12,14,75,1014,13.5,5,4,35,8.8,0,79,1049,13.3,5,xavier-worthy-1
165,Kaedin Robinson*,Appalachian State,Sun Belt,14,67,905,13.5,10,1,1,1.0,0,68,906,13.3,10,kaedin-robinson-1
166,Jordan Moore*,Duke,ACC,13,62,835,13.5,8,4,2,0.5,0,66,837,12.7,8,jordan-moore-5
167,Xzavier Henderson,Cincinnati,Big 12,12,58,782,13.5,3,0,0,,0,58,782,13.5,3,xzavier-henderson-1
168,Tayvion Robinson*,Kentucky,SEC,13,41,552,13.5,4,2,12,6.0,0,43,564,13.1,4,tayvion-robinson-1
169,Evan Stewart*,Texas A&M,SEC,8,38,514,13.5,4,1,-3,-3.0,0,39,511,13.1,4,evan-stewart-2
170,Javon Harvey*,Old Dominion,Sun Belt,9,29,391,13.5,4,0,0,,0,29,391,13.5,4,javon-harvey-1
171,Xavier Weaver,Colorado,Pac-12,11,68,908,13.4,4,2,15,7.5,2,70,923,13.2,6,xavier-weaver-1
172,Jerjuan Newton*,Toledo,MAC,14,52,696,13.4,9,1,2,2.0,0,53,698,13.2,9,jerjuan-newton-1
173,Donaven McCulley,Indiana,Big Ten,12,48,644,13.4,6,3,-1,-0.3,0,51,643,12.6,6,donaven-mcculley-1
174,Deion Burks,Purdue,Big Ten,12,47,629,13.4,7,4,12,3.0,0,51,641,12.6,7,deion-burks-1
175,Montorie Foster,Michigan State,Big Ten,12,43,576,13.4,3,0,0,,0,43,576,13.4,3,montorie-foster-1
176,David Martin-Robinson,Temple,American,12,40,537,13.4,4,9,13,1.4,1,49,550,11.2,5,david-martin-robinson-1
177,Beaux Collins*,Clemson,ACC,11,38,510,13.4,3,0,0,,0,38,510,13.4,3,beaux-collins-1
178,Corey Crooms*,Minnesota,Big Ten,13,28,376,13.4,0,0,0,,0,28,376,13.4,0,corey-crooms-1
179,Mekhi Shaw,San Diego State,MWC,10,28,375,13.4,2,0,0,,0,28,375,13.4,2,mekhi-shaw-1
180,Jabre Barber*,Troy,Sun Belt,14,75,999,13.3,5,3,16,5.3,0,78,1015,13.0,5,jabre-barber-1
181,Jalon Calhoun*,Duke,ACC,13,50,666,13.3,4,1,3,3.0,0,51,669,13.1,4,jalon-calhoun-1
182,Hamze El-Zayat*,Eastern Michigan,MAC,13,27,360,13.3,2,2,7,3.5,0,29,367,12.7,2,hamze-el-zayat-2
183,Charles Ross*,San Jose State,MWC,12,26,347,13.3,1,0,0,,0,26,347,13.3,1,charles-ross-2
184,Cam Johnson*,Northwestern,Big Ten,13,54,715,13.2,6,1,8,8.0,0,55,723,13.1,6,cam-johnson-2
185,Keon Coleman*,Florida State,ACC,12,50,658,13.2,11,1,2,2.0,0,51,660,12.9,11,keon-coleman-1
186,Lideatrick Griffin,Mississippi State,SEC,12,50,658,13.2,4,17,74,4.4,1,67,732,10.9,5,lideatrick-griffin-1
187,Chase Sowell,East Carolina,American,12,47,622,13.2,1,0,0,,0,47,622,13.2,1,chase-sowell-1
188,Ashton Jeanty*,Boise State,MWC,12,43,569,13.2,5,220,1347,6.1,14,263,1916,7.3,19,ashton-jeanty-1
189,Deshon Stoudemire*,Troy,Sun Belt,14,43,569,13.2,1,0,0,,0,43,569,13.2,1,deshon-stoudemire-1
190,Abdur-Rahmaan Yaseen,Purdue,Big Ten,6,25,329,13.2,0,0,0,,0,25,329,13.2,0,abdur-rahmaan-yaseen-1
191,Sam Brown,Houston,Big 12,12,62,815,13.1,3,0,0,,0,62,815,13.1,3,sam-brown-5
192,Erik Brooks*,Fresno State,MWC,13,60,788,13.1,5,0,0,,0,60,788,13.1,5,erik-brooks-1
193,Miles Cross*,Ohio,MAC,11,47,617,13.1,5,0,0,,0,47,617,13.1,5,miles-cross-1
194,Konata Mumpfield,Pitt,ACC,12,44,576,13.1,5,1,15,15.0,0,45,591,13.1,5,konata-mumpfield-1
195,Jaylin Lane*,Virginia Tech,ACC,12,41,538,13.1,6,14,51,3.6,0,55,589,10.7,6,jaylin-lane-1
196,Dashaun Davis*,Appalachian State,Sun Belt,13,29,381,13.1,3,1,10,10.0,0,30,391,13.0,3,dashaun-davis-1
197,Dae'Quan Wright*,Virginia Tech,ACC,12,28,366,13.1,0,0,0,,0,28,366,13.1,0,daequan-wright-1
198,Malik Washington,Virginia,ACC,12,110,1426,13.0,9,3,7,2.3,0,113,1433,12.7,9,malik-washington-1
199,Pat Bryant,Illinois,Big Ten,12,43,560,13.0,7,0,0,,0,43,560,13.0,7,pat-bryant-1
200,Braden Smith,Cincinnati,Big 12,12,43,557,13.0,4,2,0,0.0,0,45,557,12.4,4,braden-smith-4
201,Devin McCuin*,UTSA,American,12,42,546,13.0,3,1,10,10.0,0,43,556,12.9,3,devin-mccuin-1
202,Dante Wright,Temple,American,11,39,507,13.0,4,2,5,2.5,0,41,512,12.5,4,dante-wright-1
203,Christian Dremel*,Rutgers,Big Ten,13,36,468,13.0,3,0,0,,0,36,468,13.0,3,christian-dremel-1
204,Mike Brown-Stephens*,South Florida,American,11,27,350,13.0,2,0,0,,0,27,350,13.0,2,mike-brown-stephens-1
205,Dylan Goffney,Colorado State,MWC,11,23,298,13.0,2,0,0,,0,23,298,13.0,2,dylan-goffney-1
206,Joshua Cephus*,UTSA,American,13,89,1151,12.9,10,1,-9,-9.0,0,90,1142,12.7,10,joshua-cephus-1
207,Isaiah Williams,Illinois,Big Ten,12,82,1055,12.9,5,12,38,3.2,0,94,1093,11.6,5,isaiah-williams-7
208,Cornelius Johnson*,Michigan,Big Ten,15,47,604,12.9,1,3,40,13.3,0,50,644,12.9,1,cornelius-johnson-1
209,Jaheim Bell*,Florida State,ACC,13,39,503,12.9,2,4,2,0.5,1,43,505,11.7,3,jaheim-bell-1
210,Xavier Restrepo*,Miami (FL),ACC,13,85,1092,12.8,6,0,0,,0,85,1092,12.8,6,xavier-restrepo-1
211,Jared Brown*,Coastal Carolina,Sun Belt,12,58,740,12.8,4,15,252,16.8,1,73,992,13.6,5,jared-brown-2
212,Brock Bowers*,Georgia,SEC,10,56,714,12.8,6,6,28,4.7,1,62,742,12.0,7,brock-bowers-1
213,Jalen Moss*,Fresno State,MWC,13,55,706,12.8,6,0,0,,0,55,706,12.8,6,jalen-moss-1
214,Neal Johnson*,Louisiana,Sun Belt,13,30,383,12.8,5,0,0,,0,30,383,12.8,5,neal-johnson-1
215,Moose Muhammad III*,Texas A&M,SEC,12,27,345,12.8,2,0,0,,0,27,345,12.8,2,moose-muhammad-iii-1
216,Isaiah Washington*,Rutgers,Big Ten,13,25,321,12.8,1,0,0,,0,25,321,12.8,1,isaiah-washington-2
217,Keandre Lambert-Smith*,Penn State,Big Ten,13,53,673,12.7,4,2,0,0.0,0,55,673,12.2,4,keandre-lambert-smith-1
218,Kole Taylor*,West Virginia,Big 12,13,35,444,12.7,4,0,0,,0,35,444,12.7,4,kole-taylor-2
219,Mark Pope,Massachusetts,Ind,12,33,420,12.7,1,5,9,1.8,0,38,429,11.3,1,mark-pope-1
220,Jaden Bray*,Oklahoma State,Big 12,10,30,382,12.7,2,1,-5,-5.0,0,31,377,12.2,2,jaden-bray-1
221,Cade McDonald*,Miami (OH),MAC,13,28,355,12.7,3,2,8,4.0,0,30,363,12.1,3,cade-mcdonald-1
222,Travis Hunter,Colorado,Pac-12,9,57,721,12.6,5,0,0,,0,57,721,12.6,5,travis-hunter-2
223,Tailique Williams*,Georgia State,Sun Belt,13,49,615,12.6,6,1,-1,-1.0,0,50,614,12.3,6,tailique-williams-1
224,Jake Bailey*,SMU,American,14,42,528,12.6,0,1,10,10.0,0,43,538,12.5,0,jake-bailey-2
225,Emeka Egbuka*,Ohio State,Big Ten,10,41,515,12.6,4,5,25,5.0,0,46,540,11.7,4,emeka-egbuka-1
226,Zavion Thomas,Mississippi State,SEC,11,40,503,12.6,1,12,23,1.9,0,52,526,10.1,1,zavion-thomas-1
227,Darius Lassiter,Brigham Young,Big 12,10,29,365,12.6,4,1,5,5.0,0,30,370,12.3,4,darius-lassiter-1
228,Benjamin Brahmer*,Iowa State,Big 12,13,28,352,12.6,2,0,0,,0,28,352,12.6,2,benjamin-brahmer-1
229,Jsi Hatfield,East Carolina,American,12,27,341,12.6,1,0,0,,0,27,341,12.6,1,jsi-hatfield-1
230,Malachi Corley*,Western Kentucky,CUSA,12,79,984,12.5,11,4,11,2.8,0,83,995,12.0,11,malachi-corley-1
231,Robert Lewis*,Georgia State,Sun Belt,12,70,877,12.5,7,0,0,,0,70,877,12.5,7,robert-lewis-9
232,Joseph Manjack IV,Houston,Big 12,10,46,577,12.5,6,2,-3,-1.5,0,48,574,12.0,6,joseph-manjack-iv-1
233,Cameron Ross,Connecticut,Ind,12,44,552,12.5,1,4,9,2.3,0,48,561,11.7,1,cameron-ross-1
234,Barion Brown*,Kentucky,SEC,13,43,539,12.5,4,12,147,12.3,1,55,686,12.5,5,barion-brown-1
235,Damon Ward,North Texas,American,12,39,487,12.5,5,0,0,,0,39,487,12.5,5,damon-ward-2
236,Joseph Scates*,Memphis,American,12,33,414,12.5,6,0,0,,0,33,414,12.5,6,joseph-scates-1
237,Jack Hestera,Charlotte,American,9,28,349,12.5,3,0,0,,0,28,349,12.5,3,jack-hestera-1
238,Jaylin Noel*,Iowa State,Big 12,12,66,820,12.4,7,1,-1,-1.0,0,67,819,12.2,7,jaylin-noel-1
239,Lewis Bond*,Boston College,ACC,13,52,646,12.4,7,1,2,2.0,0,53,648,12.2,7,lewis-bond-1
240,Jalen McMillan*,Washington,Pac-12,11,45,559,12.4,5,3,30,10.0,1,48,589,12.3,6,jalen-mcmillan-1
241,Marlyn Johnson,Buffalo,MAC,12,40,494,12.4,4,0,0,,0,40,494,12.4,4,marlyn-johnson-1
242,Jeremiah Hixon,New Mexico,MWC,11,39,482,12.4,5,2,10,5.0,0,41,492,12.0,5,jeremiah-hixon-2
243,Mookie Cooper*,Missouri,SEC,13,36,447,12.4,0,1,3,3.0,0,37,450,12.2,0,mookie-cooper-1
244,Isaac Rex,Brigham Young,Big 12,12,34,422,12.4,3,0,0,,0,34,422,12.4,3,isaac-rex-1
245,Tyler Warren*,Penn State,Big Ten,13,34,422,12.4,7,0,0,,0,34,422,12.4,7,tyler-warren-1
246,Jaylon Robinson,TCU,Big 12,10,32,397,12.4,1,2,-2,-1.0,0,34,395,11.6,1,jaylon-robinson-1
247,Robert Williams*,Louisiana,Sun Belt,11,31,385,12.4,4,0,0,,0,31,385,12.4,4,robert-williams-15
248,Spencer Curtis,Nevada,MWC,11,30,373,12.4,1,0,0,,0,30,373,12.4,1,spencer-curtis-1
249,Noah Thomas*,Texas A&M,SEC,11,29,359,12.4,5,0,0,,0,29,359,12.4,5,noah-thomas-1
250,DJ England-Chisolm,Middle Tennessee State,CUSA,12,28,347,12.4,3,0,0,,0,28,347,12.4,3,dj-england-chisolm-1
251,Christian Leary*,Georgia Tech,ACC,13,25,309,12.4,2,2,-2,-1.0,0,27,307,11.4,2,christian-leary-1
252,Jameel Gardner,Kent State,MAC,12,24,298,12.4,1,0,0,,0,24,298,12.4,1,jameel-gardner-1
253,Zae Baines,Temple,American,11,36,442,12.3,1,2,7,3.5,0,38,449,11.8,1,zae-baines-1
254,Malik Phillips,Sam Houston,CUSA,12,35,430,12.3,1,3,9,3.0,0,38,439,11.6,1,malik-phillips-1
255,Germie Bernard*,Washington,Pac-12,14,34,419,12.3,2,13,43,3.3,2,47,462,9.8,4,germie-bernard-1
256,Tru Edwards,Louisiana Tech,CUSA,11,23,284,12.3,2,0,0,,0,23,284,12.3,2,tru-edwards-1
257,Jacob Bernard*,Louisiana,Sun Belt,13,39,476,12.2,1,0,0,,0,39,476,12.2,1,jacob-bernard-1
258,Traeshon Holden*,Oregon,Pac-12,14,37,452,12.2,6,2,12,6.0,1,39,464,11.9,7,traeshon-holden-1
259,Dillon Bell*,Georgia,SEC,14,29,355,12.2,2,25,157,6.3,2,54,512,9.5,4,dillon-bell-1
260,E.J. Williams,Indiana,Big Ten,8,23,281,12.2,0,0,0,,0,23,281,12.2,0,ej-williams-2
261,Landon Sides,North Texas,American,11,30,363,12.1,4,4,25,6.3,0,34,388,11.4,4,landon-sides-1
262,Jalin Conyers,Arizona State,Pac-12,11,30,362,12.1,0,22,92,4.2,1,52,454,8.7,1,jalin-conyers-1
263,Brionne Penny,San Diego State,MWC,11,24,290,12.1,1,0,0,,0,24,290,12.1,1,brionne-penny-1
264,Squirrel White*,Tennessee,SEC,13,67,803,12.0,2,2,13,6.5,0,69,816,11.8,2,squirrel-white-1
265,Dallin Holker,Colorado State,MWC,12,64,767,12.0,6,1,1,1.0,1,65,768,11.8,7,dallin-holker-1
266,Tyrone Howell,Louisiana-Monroe,Sun Belt,12,49,590,12.0,7,0,0,,0,49,590,12.0,7,tyrone-howell-1
267,Colbie Young*,Miami (FL),ACC,12,47,563,12.0,5,0,0,,0,47,563,12.0,5,colbie-young-1
268,Jordan Whittington*,Texas,Big 12,14,42,505,12.0,1,3,18,6.0,0,45,523,11.6,1,jordan-whittington-2
269,Jerand Bradley*,Texas Tech,Big 12,12,36,431,12.0,4,0,0,,0,36,431,12.0,4,jerand-bradley-1
270,George Johnson,Massachusetts,Ind,12,35,421,12.0,3,0,0,,0,35,421,12.0,3,george-johnson-6
271,TJ Sheffield,Purdue,Big Ten,11,32,381,11.9,2,0,0,,0,32,381,11.9,2,tj-sheffield-1
272,Donovan Brown*,Syracuse,ACC,13,27,321,11.9,1,1,-3,-3.0,0,28,318,11.4,1,donovan-brown-1
273,Cameron Skattebo,Arizona State,Pac-12,12,24,286,11.9,1,164,783,4.8,9,188,1069,5.7,10,cameron-skattebo-1
274,Tory Horton,Colorado State,MWC,12,96,1136,11.8,8,0,0,,0,96,1136,11.8,8,tory-horton-1
275,Joey Hobert*,Texas State,Sun Belt,11,76,895,11.8,8,1,-1,-1.0,0,77,894,11.6,8,joey-hobert-1
276,Kevin Concepcion*,North Carolina State,ACC,13,71,839,11.8,10,41,320,7.8,0,112,1159,10.3,10,kevin-concepcion-2
277,Sam Wiglusz*,Ohio,MAC,12,56,660,11.8,3,1,1,1.0,0,57,661,11.6,3,sam-wiglusz-1
278,Odieu Hiliare*,Bowling Green State,MAC,13,45,532,11.8,4,1,12,12.0,0,46,544,11.8,4,odieu-hiliare-1
279,Yulkeith Brown*,Tulane,American,13,33,391,11.8,2,6,64,10.7,2,39,455,11.7,4,yulkeith-brown-1
280,Nicholas Singleton*,Penn State,Big Ten,13,26,308,11.8,2,171,752,4.4,8,197,1060,5.4,10,nicholas-singleton-1
281,Elijah Metcalf,Middle Tennessee State,CUSA,12,54,634,11.7,5,1,5,5.0,0,55,639,11.6,5,elijah-metcalf-1
282,John Paul Richardson,TCU,Big 12,12,46,536,11.7,3,3,12,4.0,0,49,548,11.2,3,john-paul-richardson-1
283,Tanner McLachlan*,Arizona,Pac-12,13,45,528,11.7,4,0,0,,0,45,528,11.7,4,tanner-mclachlan-2
284,Maliq Carr,Michigan State,Big Ten,10,30,352,11.7,3,0,0,,0,30,352,11.7,3,maliq-carr-1
285,Jeremiah Hunter*,California,Pac-12,13,63,731,11.6,7,0,0,,0,63,731,11.6,7,jeremiah-hunter-1
286,Coy Eakin*,Texas Tech,Big 12,10,36,416,11.6,2,1,-1,-1.0,0,37,415,11.2,2,coy-eakin-1
287,Jack Endries*,California,Pac-12,13,35,407,11.6,2,0,0,,0,35,407,11.6,2,jack-endries-1
288,Eric Rivers,Florida International,CUSA,11,32,370,11.6,2,1,3,3.0,0,33,373,11.3,2,eric-rivers-2
289,DJ Washington,New Mexico,MWC,12,29,336,11.6,3,0,0,,0,29,336,11.6,3,dj-washington-3
290,Sean Atkins*,South Florida,American,13,92,1054,11.5,7,6,52,8.7,0,98,1106,11.3,7,sean-atkins-1
291,Drake Stoops*,Oklahoma,Big 12,13,84,962,11.5,10,4,8,2.0,0,88,970,11.0,10,drake-stoops-1
292,Easton Messer*,Western Kentucky,CUSA,13,42,484,11.5,4,2,16,8.0,0,44,500,11.4,4,easton-messer-1
293,Jordan Smith,Temple,American,12,25,287,11.5,4,0,0,,0,25,287,11.5,4,jordan-smith-7
294,Je'Quan Burton,Florida Atlantic,American,11,24,277,11.5,2,1,15,15.0,0,25,292,11.7,2,jequan-burton-1
295,Stephon Johnson Jr.,Houston,Big 12,12,24,277,11.5,3,1,13,13.0,0,25,290,11.6,3,stephon-johnson-jr-1
296,Dominic Lovett*,Georgia,SEC,14,54,613,11.4,4,0,0,,0,54,613,11.4,4,dominic-lovett-1
297,Roderic Burns,North Texas,American,12,41,466,11.4,4,0,0,,0,41,466,11.4,4,roderic-burns-1
298,Tiaquelin Mims,Southern Mississippi,Sun Belt,12,39,445,11.4,2,5,28,5.6,0,44,473,10.8,2,tiaquelin-mims-1
299,Tiger Bachmeier,Stanford,Pac-12,12,36,409,11.4,2,2,29,14.5,1,38,438,11.5,3,tiger-bachmeier-1
300,JB Mitchell III*,Eastern Michigan,MAC,12,35,398,11.4,1,1,1,1.0,0,36,399,11.1,1,jb-mitchell-iii-1
301,Ahmad Edwards,Ball State,MAC,12,31,354,11.4,1,2,12,6.0,0,33,366,11.1,1,ahmad-edwards-1
302,Quinton Lane*,Jacksonville State,CUSA,13,30,342,11.4,1,0,0,,0,30,342,11.4,1,quinton-lane-2
303,Will Pauling*,Wisconsin,Big Ten,13,74,837,11.3,6,1,11,11.0,0,75,848,11.3,6,will-pauling-1
304,Kole Wilson*,Texas State,Sun Belt,13,66,747,11.3,8,2,-7,-3.5,0,68,740,10.9,8,kole-wilson-1
305,Daejon Reynolds,Pitt,ACC,12,28,316,11.3,0,1,1,1.0,0,29,317,10.9,0,daejon-reynolds-1
306,Jonah Coleman*,Arizona,Pac-12,13,25,283,11.3,1,128,871,6.8,5,153,1154,7.5,6,jonah-coleman-1
307,Chamon Metayer,Cincinnati,Big 12,11,23,258,11.2,5,1,27,27.0,0,24,285,11.9,5,chamon-metayer-1
308,Logan Loya*,UCLA,Pac-12,13,59,655,11.1,5,0,0,,0,59,655,11.1,5,logan-loya-1
309,Jahmal Banks,Wake Forest,ACC,12,59,653,11.1,4,1,7,7.0,0,60,660,11.0,4,jahmal-banks-1
310,Phillip Brooks*,Kansas State,Big 12,12,53,589,11.1,5,7,33,4.7,1,60,622,10.4,6,phillip-brooks-1
311,Jared Wiley,TCU,Big 12,12,47,520,11.1,8,0,0,,0,47,520,11.1,8,jared-wiley-1
312,Tony Johnson,Florida Atlantic,American,12,37,411,11.1,4,1,10,10.0,0,38,421,11.1,4,tony-johnson-10
313,Leroy Thomas,Western Michigan,MAC,12,35,389,11.1,2,7,39,5.6,0,42,428,10.2,2,leroy-thomas-3
314,DJ Giddens*,Kansas State,Big 12,13,29,323,11.1,3,223,1226,5.5,10,252,1549,6.1,13,dj-giddens-1
315,Arlis Boardingham,Florida,SEC,12,26,289,11.1,4,0,0,,0,26,289,11.1,4,arlis-boardingham-1
316,Derwin Burgess Jr.*,Georgia Southern,Sun Belt,13,74,813,11.0,6,0,0,,0,74,813,11.0,6,derwin-burgess-jr-1
317,Elijhah Badger,Arizona State,Pac-12,11,65,713,11.0,3,11,51,4.6,1,76,764,10.1,4,elijhah-badger-1
318,Malik Rutherford*,Georgia Tech,ACC,13,46,502,10.9,4,3,17,5.7,0,49,519,10.6,4,malik-rutherford-1
319,Wyatt Wieland*,Wyoming,MWC,13,44,480,10.9,5,7,22,3.1,1,51,502,9.8,6,wyatt-wieland-1
320,Al'Vonte Woodard,Sam Houston,CUSA,11,31,339,10.9,2,0,0,,0,31,339,10.9,2,alvonte-woodard-1
321,Michael Wiley*,Arizona,Pac-12,10,28,306,10.9,5,70,311,4.4,3,98,617,6.3,8,michael-wiley-3
322,LaJohntay Wester,Florida Atlantic,American,12,108,1168,10.8,8,8,44,5.5,1,116,1212,10.4,9,lajohntay-wester-1
323,Mac Dalena*,Fresno State,MWC,13,47,509,10.8,3,1,33,33.0,0,48,542,11.3,3,mac-dalena-1
324,Austin Hence,Western Michigan,MAC,12,25,269,10.8,3,0,0,,0,25,269,10.8,3,austin-hence-1
325,Carlos Hernandez,Washington State,Pac-12,12,24,258,10.8,0,0,0,,0,24,258,10.8,0,carlos-hernandez-1
326,Nate McCollum*,North Carolina,ACC,10,44,469,10.7,1,0,0,,0,44,469,10.7,1,nate-mccollum-1
327,Devonte Ross*,Troy,Sun Belt,14,40,428,10.7,3,1,2,2.0,0,41,430,10.5,3,devonte-ross-2
328,Mark Redman,San Diego State,MWC,12,38,408,10.7,3,0,0,,0,38,408,10.7,3,mark-redman-1
329,Koby Drake*,Memphis,American,12,33,352,10.7,2,0,0,,0,33,352,10.7,2,koby-drake-1
330,Brett Buckman,Connecticut,Ind,12,46,488,10.6,2,2,-6,-3.0,0,48,482,10.0,2,brett-buckman-1
331,Luke Floriea,Kent State,MAC,12,39,413,10.6,4,1,13,13.0,1,40,426,10.7,5,luke-floriea-1
332,Matthew Golden,Houston,Big 12,9,38,404,10.6,6,0,0,,0,38,404,10.6,6,matthew-golden-1
333,Jayden McGowan,Vanderbilt,SEC,12,36,383,10.6,0,18,109,6.1,0,54,492,9.1,0,jayden-mcgowan-1
334,Colin Weber,Charlotte,American,12,34,362,10.6,0,0,0,,0,34,362,10.6,0,colin-weber-1
335,Montana Lemonious-Craig*,Arizona,Pac-12,13,28,296,10.6,3,0,0,,0,28,296,10.6,3,montana-lemonious-craig-1
336,Cadarrius Thompson*,Georgia State,Sun Belt,13,25,266,10.6,3,0,0,,0,25,266,10.6,3,cadarrius-thompson-1
337,Terrell Vaughn*,Utah State,MWC,13,89,933,10.5,11,4,3,0.8,0,93,936,10.1,11,terrell-vaughn-1
338,Jasaiah Gathings,Akron,MAC,12,55,575,10.5,1,0,0,,0,55,575,10.5,1,jasaiah-gathings-1
339,Jaelen Gill*,Fresno State,MWC,13,49,516,10.5,6,10,24,2.4,0,59,540,9.2,6,jaelen-gill-1
340,Justin Olson,Middle Tennessee State,CUSA,10,43,450,10.5,1,0,0,,0,43,450,10.5,1,justin-olson-1
341,Eli Stowers*,New Mexico State,CUSA,15,35,366,10.5,2,28,108,3.9,2,63,474,7.5,4,eli-stowers-1
342,Jay Fair*,Auburn,SEC,13,31,324,10.5,2,0,0,,0,31,324,10.5,2,jay-fair-1
343,Mario Williams*,USC,Pac-12,12,29,305,10.5,2,2,0,0.0,0,31,305,9.8,2,mario-williams-2
344,Trayvon Rudolph*,Northern Illinois,MAC,13,51,531,10.4,2,22,182,8.3,1,73,713,9.8,3,trayvon-rudolph-1
345,Jaylen Johnson,East Carolina,American,12,45,466,10.4,2,0,0,,0,45,466,10.4,2,jaylen-johnson-3
346,Taron Keith*,Bowling Green State,MAC,12,44,457,10.4,3,66,390,5.9,4,110,847,7.7,7,taron-keith-1
347,Rivaldo Fairweather*,Auburn,SEC,13,38,394,10.4,6,0,0,,0,38,394,10.4,6,rivaldo-fairweather-1
348,Boobie Curry,Buffalo,MAC,12,29,303,10.4,1,0,0,,0,29,303,10.4,1,boobie-curry-1
349,Austin Osborne*,Bowling Green State,MAC,13,29,302,10.4,0,0,0,,0,29,302,10.4,0,austin-osborne-1
350,Julian Fleming*,Ohio State,Big Ten,12,26,270,10.4,0,0,0,,0,26,270,10.4,0,julian-fleming-1
351,Thomas Fidone III,Nebraska,Big Ten,12,25,260,10.4,4,0,0,,0,25,260,10.4,4,thomas-fidone-iii-1
352,Justin Joly,Connecticut,Ind,12,56,578,10.3,2,0,0,,0,56,578,10.3,2,justin-joly-1
353,Dalvin Smith*,Western Kentucky,CUSA,11,50,513,10.3,6,1,25,25.0,0,51,538,10.5,6,dalvin-smith-1
354,Isiah Paige*,Old Dominion,Sun Belt,11,43,445,10.3,2,1,-8,-8.0,0,44,437,9.9,2,isiah-paige-1
355,Isaac TeSlaa,Arkansas,SEC,12,34,351,10.3,2,1,0,0.0,0,35,351,10.0,2,isaac-teslaa-1
356,Eli Wilson*,Appalachian State,Sun Belt,14,34,350,10.3,5,0,0,,1,34,350,10.3,6,eli-wilson-1
357,Zachariah Branch*,USC,Pac-12,11,31,320,10.3,2,9,70,7.8,1,40,390,9.8,3,zachariah-branch-1
358,Marion Lukes,Central Michigan,MAC,12,29,300,10.3,0,144,737,5.1,5,173,1037,6.0,5,marion-lukes-1
359,Sam Roush,Stanford,Pac-12,12,28,288,10.3,0,1,1,1.0,0,29,289,10.0,0,sam-roush-1
360,Tre Mosley,Michigan State,Big Ten,8,28,288,10.3,2,0,0,,0,28,288,10.3,2,tre-mosley-1
361,Tyler Brown*,Clemson,ACC,13,52,531,10.2,4,2,41,20.5,0,54,572,10.6,4,tyler-brown-7
362,Daniel George,Akron,MAC,12,52,529,10.2,1,0,0,,0,52,529,10.2,1,daniel-george-1
363,Louis Brown,Colorado State,MWC,12,47,481,10.2,5,3,5,1.7,0,50,486,9.7,5,louis-brown-4
364,Taj Davis*,California,Pac-12,11,39,399,10.2,3,1,1,1.0,0,40,400,10.0,3,taj-davis-1
365,Jjay Mcafee*,Georgia Southern,Sun Belt,12,37,378,10.2,4,0,0,,0,37,378,10.2,4,jjay-mcafee-1
366,Jalen Bracey,Florida International,CUSA,12,31,316,10.2,1,4,19,4.8,0,35,335,9.6,1,jalen-bracey-1
367,Zach Horton*,James Madison,Sun Belt,13,27,275,10.2,6,0,0,,0,27,275,10.2,6,zach-horton-1
368,Ahmarean Brown,South Carolina,SEC,9,26,265,10.2,1,2,0,0.0,0,28,265,9.5,1,ahmarean-brown-1
369,Duane Thomas Jr.,Charlotte,American,12,24,244,10.2,0,5,11,2.2,0,29,255,8.8,0,duane-thomas-jr-1
370,Jacob De Jesus*,UNLV,MWC,14,60,606,10.1,2,11,46,4.2,1,71,652,9.2,3,jacob-de-jesus-1
371,Jermaine Brown Jr.,UAB,American,12,41,416,10.1,1,158,803,5.1,12,199,1219,6.1,13,jermaine-brown-jr-1
372,Ke'Shawn Williams,Wake Forest,ACC,11,38,384,10.1,1,3,29,9.7,1,41,413,10.1,2,keshawn-williams-2
373,Lake McRee*,USC,Pac-12,12,26,262,10.1,1,0,0,,0,26,262,10.1,1,lake-mcree-1
374,Bryce Damous,UAB,American,12,24,242,10.1,3,0,0,,0,24,242,10.1,3,bryce-damous-1
375,Pofele Ashlock,Hawaii,MWC,13,83,832,10.0,9,0,0,,0,83,832,10.0,9,pofele-ashlock-1
376,Jake Briningstool*,Clemson,ACC,13,50,498,10.0,5,0,0,,0,50,498,10.0,5,jake-briningstool-1
377,Corey Dyches*,Maryland,Big Ten,11,49,491,10.0,2,0,0,,0,49,491,10.0,2,corey-dyches-1
378,Theo Johnson*,Penn State,Big Ten,13,34,341,10.0,7,0,0,,0,34,341,10.0,7,theo-johnson-1
379,Quali Conley*,San Jose State,MWC,13,27,269,10.0,0,131,842,6.4,9,158,1111,7.0,9,quali-conley-1
380,Jake Roberts,Baylor,Big 12,12,23,231,10.0,1,0,0,,0,23,231,10.0,1,jake-roberts-1
381,Noah Smith,Sam Houston,CUSA,12,79,782,9.9,6,27,102,3.8,2,106,884,8.3,8,noah-smith-3
382,Terrance Ferguson*,Oregon,Pac-12,14,42,414,9.9,6,0,0,,0,42,414,9.9,6,terrance-ferguson-1
383,Tre Watson*,Fresno State,MWC,13,38,378,9.9,4,0,0,,0,38,378,9.9,4,tre-watson-4
384,Treyton Welch*,Wyoming,MWC,13,31,308,9.9,2,0,0,,0,31,308,9.9,2,treyton-welch-1
385,Brennan Presley*,Oklahoma State,Big 12,14,101,991,9.8,6,11,41,3.7,2,112,1032,9.2,8,brennan-presley-1
386,Jimmy Horn Jr.,Colorado,Pac-12,12,58,567,9.8,6,2,18,9.0,0,60,585,9.8,6,jimmy-horn-jr-1
387,Boden Groen*,Rice,American,13,39,383,9.8,3,0,0,,0,39,383,9.8,3,boden-groen-1
388,Xavier Townsend*,UCF,Big 12,11,33,325,9.8,3,15,163,10.9,0,48,488,10.2,3,xavier-townsend-1
389,Re'Mahn Davis*,Kentucky,SEC,13,33,323,9.8,7,199,1129,5.7,14,232,1452,6.3,21,remahn-davis-1
390,Anthony Queeley*,Georgia Southern,Sun Belt,12,28,275,9.8,3,0,0,,0,28,275,9.8,3,anthony-queeley-1
391,Lincoln Victor,Washington State,Pac-12,11,89,860,9.7,5,3,21,7.0,1,92,881,9.6,6,lincoln-victor-1
392,Lorenzo Lingard,Akron,MAC,12,38,368,9.7,2,143,641,4.5,4,181,1009,5.6,6,lorenzo-lingard-1
393,Mason Taylor*,LSU,SEC,12,36,348,9.7,1,0,0,,0,36,348,9.7,1,mason-taylor-1
394,Smoke Harris,Louisiana Tech,CUSA,12,83,796,9.6,4,9,1,0.1,0,92,797,8.7,4,smoke-harris-1
395,Tanner Knue*,Eastern Michigan,MAC,12,50,479,9.6,3,1,2,2.0,0,51,481,9.4,3,tanner-knue-1
396,Brevyn Spann-Ford*,Minnesota,Big Ten,12,25,239,9.6,2,0,0,,0,25,239,9.6,2,brevyn-spann-ford-1
397,Nakia Watson,Washington State,Pac-12,12,24,230,9.6,3,89,321,3.6,4,113,551,4.9,7,nakia-watson-1
398,Myles Price*,Texas Tech,Big 12,10,43,410,9.5,5,0,0,,0,43,410,9.5,5,myles-price-1
399,Money Parks*,Utah,Pac-12,13,31,293,9.5,2,7,45,6.4,0,38,338,8.9,2,money-parks-1
400,Khaleb Hood*,Georgia Southern,Sun Belt,13,101,948,9.4,5,3,23,7.7,0,104,971,9.3,5,khaleb-hood-1
401,Jacob Cowing*,Arizona,Pac-12,13,90,848,9.4,13,5,26,5.2,0,95,874,9.2,13,jacob-cowing-1
402,Jack Westover*,Washington,Pac-12,15,46,433,9.4,4,1,1,1.0,1,47,434,9.2,5,jack-westover-1
403,Dean Connors*,Rice,American,13,43,403,9.4,3,121,771,6.4,7,164,1174,7.2,10,dean-connors-1
404,Tyler Walton*,Ohio,MAC,12,37,349,9.4,2,5,34,6.8,0,42,383,9.1,2,tyler-walton-1
405,Kaelon Black*,James Madison,Sun Belt,13,27,254,9.4,4,142,637,4.5,1,169,891,5.3,5,kaelon-black-1
406,A.J. Henning*,Northwestern,Big Ten,12,45,418,9.3,4,27,110,4.1,1,72,528,7.3,5,aj-henning-1
407,Roman Hemby*,Maryland,Big Ten,13,38,349,9.2,3,142,680,4.8,4,180,1029,5.7,7,roman-hemby-1
408,Michael Harrison,Colorado,Pac-12,12,31,284,9.2,5,0,0,,0,31,284,9.2,5,michael-harrison-2
409,Darvon Hubbard,Temple,American,12,27,249,9.2,0,83,412,5.0,3,110,661,6.0,3,darvon-hubbard-1
410,Kenneth Womack,Western Michigan,MAC,12,76,691,9.1,1,0,3,,0,76,694,9.1,1,kenneth-womack-1
411,Blake Watson*,Memphis,American,13,53,480,9.1,3,192,1152,6.0,14,245,1632,6.7,17,blake-watson-2
412,Joshua Simon,South Carolina,SEC,12,28,256,9.1,2,0,0,,0,28,256,9.1,2,joshua-simon-1
413,Terrance Carter*,Louisiana,Sun Belt,12,28,255,9.1,3,0,0,,0,28,255,9.1,3,terrance-carter-2
414,Mikey Matthews*,Utah,Pac-12,12,29,261,9.0,0,1,4,4.0,0,30,265,8.8,0,mikey-matthews-1
415,Anthony Landphere*,Memphis,American,13,29,260,9.0,3,0,0,,0,29,260,9.0,3,anthony-landphere-2
416,Billy Kemp,Nebraska,Big Ten,11,35,310,8.9,1,3,13,4.3,1,38,323,8.5,2,billy-kemp-2
417,Bhayshul Tuten*,Virginia Tech,ACC,13,27,239,8.9,2,173,863,5.0,10,200,1102,5.5,12,bhayshul-tuten-1
418,Eugene Wilson III,Florida,SEC,10,61,538,8.8,6,6,55,9.2,0,67,593,8.9,6,eugene-wilson-iii-1
419,Oscar Cardenas*,UTSA,American,13,32,280,8.8,2,2,5,2.5,0,34,285,8.4,2,oscar-cardenas-1
420,Drae McCray*,Texas Tech,Big 12,13,29,255,8.8,2,1,4,4.0,0,30,259,8.6,2,drae-mccray-1
421,Keyon Lesane*,North Carolina State,ACC,13,28,247,8.8,0,4,31,7.8,0,32,278,8.7,0,keyon-lesane-1
422,Qian Magwood,Ball State,MAC,12,41,358,8.7,1,0,0,,0,41,358,8.7,1,qian-magwood-2
423,Tanner Koziol,Ball State,MAC,12,34,295,8.7,3,0,0,,0,34,295,8.7,3,tanner-koziol-1
424,Shamir Hagans*,Duke,ACC,13,30,260,8.7,0,0,0,,0,30,260,8.7,0,shamir-hagans-1
425,Damarcus Thomas*,South Alabama,Sun Belt,13,27,235,8.7,5,0,0,,0,27,235,8.7,5,damarcus-thomas-2
426,Devin Neal*,Kansas,Big 12,13,25,217,8.7,1,203,1280,6.3,16,228,1497,6.6,17,devin-neal-3
427,Phoenix Sproles*,James Madison,Sun Belt,13,52,442,8.5,5,0,0,,0,52,442,8.5,5,phoenix-sproles-1
428,Ollie Gordon*,Oklahoma State,Big 12,14,39,330,8.5,1,285,1732,6.1,21,324,2062,6.4,22,ollie-gordon-1
429,Troy Stellato*,Clemson,ACC,12,38,321,8.4,1,0,0,,0,38,321,8.4,1,troy-stellato-1
430,Trey Knox,South Carolina,SEC,10,37,312,8.4,2,0,0,,0,37,312,8.4,2,trey-knox-1
431,Cole Harrity,Buffalo,MAC,12,35,294,8.4,3,4,18,4.5,0,39,312,8.0,3,cole-harrity-1
432,Koali Nishigaya,Hawaii,MWC,13,39,322,8.3,1,0,0,,0,39,322,8.3,1,koali-nishigaya-1
433,Dylan Edwards,Colorado,Pac-12,12,36,299,8.3,4,76,321,4.2,1,112,620,5.5,5,dylan-edwards-1
434,Donovan Edwards*,Michigan,Big Ten,15,30,249,8.3,0,119,497,4.2,5,149,746,5.0,5,donovan-edwards-1
435,Craig Burt Jr.*,Western Kentucky,CUSA,12,28,233,8.3,3,0,0,,0,28,233,8.3,3,craig-burt-jr-1
436,Amare Thomas,UAB,American,12,53,437,8.2,3,4,40,10.0,0,57,477,8.4,3,amare-thomas-1
437,Alex Bauman*,Tulane,American,14,35,286,8.2,5,0,0,,0,35,286,8.2,5,alex-bauman-1
438,Jamaal Bell,Nevada,MWC,12,32,262,8.2,1,32,114,3.6,1,64,376,5.9,2,jamaal-bell-1
439,Nico Ragaini*,Iowa,Big Ten,14,31,255,8.2,0,3,-4,-1.3,0,34,251,7.4,0,nico-ragaini-1
440,Frank Gore Jr.,Southern Mississippi,Sun Belt,12,27,221,8.2,3,231,1131,4.9,10,258,1352,5.2,13,frank-gore-jr-1
441,Larry McCammon III,Florida Atlantic,American,11,25,205,8.2,0,149,681,4.6,5,174,886,5.1,5,larry-mccammon-iii-1
442,Samario Rudolph,UAB,American,12,25,205,8.2,1,0,0,,0,25,205,8.2,1,samario-rudolph-1
443,Garrett Miller,Purdue,Big Ten,11,30,243,8.1,2,0,0,,0,30,243,8.1,2,garrett-miller-2
444,Tyrell Henry,Michigan State,Big Ten,12,24,195,8.1,3,0,0,,0,24,195,8.1,3,tyrell-henry-1
445,Caleb Coombs*,Marshall,Sun Belt,12,39,310,7.9,2,0,0,,0,39,310,7.9,2,caleb-coombs-1
446,Will Shipley*,Clemson,ACC,12,31,244,7.9,2,167,827,5.0,5,198,1071,5.4,7,will-shipley-1
447,Montrell Johnson,Florida,SEC,12,30,236,7.9,1,152,817,5.4,5,182,1053,5.8,6,montrell-johnson-1
448,Nyny Davis,Louisiana-Monroe,Sun Belt,12,28,222,7.9,2,1,14,14.0,0,29,236,8.1,2,nyny-davis-1
449,Skyler Bell*,Wisconsin,Big Ten,12,38,296,7.8,1,0,0,,0,38,296,7.8,1,skyler-bell-1
450,Omarion Hampton*,North Carolina,ACC,13,29,222,7.7,1,253,1504,5.9,15,282,1726,6.1,16,omarion-hampton-1
451,Dawson Pendergrass,Baylor,Big 12,11,26,199,7.7,2,79,338,4.3,5,105,537,5.1,7,dawson-pendergrass-1
452,John Jackson III,Nevada,MWC,12,35,267,7.6,0,0,0,,0,35,267,7.6,0,john-jackson-iii-1
453,Ron Cook Jr.,Buffalo,MAC,12,29,220,7.6,1,148,609,4.1,6,177,829,4.7,7,ron-cook-jr-1
454,Rasheen Ali*,Marshall,Sun Belt,12,28,213,7.6,1,212,1135,5.4,15,240,1348,5.6,16,rasheen-ali-1
455,John Gentry,Sam Houston,CUSA,10,35,261,7.5,2,119,392,3.3,3,154,653,4.2,5,john-gentry-1
456,Bucky Irving*,Oregon,Pac-12,14,56,413,7.4,2,186,1180,6.3,11,242,1593,6.6,13,markeise-irving-1
457,Emani Bailey,TCU,Big 12,12,25,184,7.4,1,223,1209,5.4,8,248,1393,5.6,9,emani-bailey-1
458,Jacari Carter*,Georgia State,Sun Belt,13,38,276,7.3,0,1,-8,-8.0,0,39,268,6.9,0,jacari-carter-1
459,Jaylin Lucas,Indiana,Big Ten,12,34,247,7.3,2,67,275,4.1,2,101,522,5.2,4,jaylin-lucas-1
460,E.J. Smith,Stanford,Pac-12,12,33,242,7.3,0,53,218,4.1,1,86,460,5.3,1,ej-smith-2
461,Jo'quavious Marks,Mississippi State,SEC,9,23,167,7.3,2,121,573,4.7,4,144,740,5.1,6,joquavious-marks-1
462,Kenan Christon,San Diego State,MWC,12,29,201,6.9,1,96,378,3.9,0,125,579,4.6,1,kenan-christon-1
463,Jaydn Ott*,California,Pac-12,12,25,169,6.8,2,246,1315,5.3,12,271,1484,5.5,14,jaydn-ott-1
464,Addison Ostrenga*,Iowa,Big Ten,12,31,192,6.2,2,0,0,,0,31,192,6.2,2,addison-ostrenga-1
465,Jaiden Credle,Middle Tennessee State,CUSA,12,24,144,6.0,1,90,427,4.7,2,114,571,5.0,3,jaiden-credle-1
466,Malik Sherrod*,Fresno State,MWC,12,44,260,5.9,1,172,966,5.6,9,216,1226,5.7,10,malik-sherrod-1
467,LeQuint Allen*,Syracuse,ACC,13,38,210,5.5,1,245,1064,4.3,9,283,1274,4.5,10,lequint-allen-1
468,Braelon Allen*,Wisconsin,Big Ten,11,28,132,4.7,0,181,984,5.4,12,209,1116,5.3,12,braelon-allen-1
469,Tahj Brooks*,Texas Tech,Big 12,13,29,72,2.5,0,290,1538,5.3,10,319,1610,5.0,10,tahj-brooks-1