Rk,Player,School,Conf,G,Rec,Yds,Avg,TD,Att,Yds,Avg,TD,Plays,Yds,Avg,TD,-9999
1,Xavier Ubosi*,UAB,CUSA,14,35,837,23.9,8,0,0,,0,35,837,23.9,8,xavier-ubosi-1
2,Emanuel Hall*,Missouri,SEC,9,37,828,22.4,6,0,0,,0,37,828,22.4,6,emanuel-hall-1
3,Hakeem Butler*,Iowa State,Big 12,13,60,1318,22.0,9,0,0,,0,60,1318,22.0,9,hakeem-butler-1
4,D.K. Metcalf,Ole Miss,SEC,7,26,569,21.9,5,0,0,,0,26,569,21.9,5,dk-metcalf-1
5,Justyn Ross*,Clemson,ACC,15,46,1000,21.7,9,0,0,,0,46,1000,21.7,9,justyn-ross-1
6,Tamorrion Terry,Florida State,ACC,12,35,744,21.3,8,0,0,,0,35,744,21.3,8,tamorrion-terry-1
7,Josh Palmer,Tennessee,SEC,12,23,484,21.0,2,5,27,5.4,1,28,511,18.3,3,josh-palmer-1
8,Darnell Mooney*,Tulane,American,13,48,993,20.7,8,1,6,6.0,0,49,999,20.4,8,darnell-mooney-1
9,Randall St. Felix*,South Florida,American,11,33,679,20.6,4,0,0,,0,33,679,20.6,4,randall-st-felix-1
10,Jon'Vea Johnson*,Toledo,MAC,13,32,660,20.6,9,0,0,,0,32,660,20.6,9,jonvea-johnson-1
11,Tre Turner*,Virginia Tech,ACC,12,26,535,20.6,4,8,101,12.6,1,34,636,18.7,5,tre-turner-2
12,Seth Williams*,Auburn,SEC,13,26,534,20.5,5,0,0,,0,26,534,20.5,5,seth-williams-1
13,D'Wayne Eskridge*,Western Michigan,MAC,11,38,776,20.4,3,0,0,,0,38,776,20.4,3,dwayne-eskridge-1
14,Austin Maloney*,Florida International,CUSA,13,30,610,20.3,5,0,0,,0,30,610,20.3,5,austin-maloney-1
15,Terry McLaurin*,Ohio State,Big Ten,14,35,701,20.0,11,0,0,,0,35,701,20.0,11,terry-mclaurin-1
16,Marcus Bennett,Air Force,MWC,12,24,465,19.4,3,0,2,,0,24,467,19.5,3,marcus-bennett-1
17,Jerry Jeudy*,Alabama,SEC,15,68,1315,19.3,14,0,0,,0,68,1315,19.3,14,jerry-jeudy-1
18,Darius Slayton*,Auburn,SEC,12,35,670,19.1,5,0,0,,0,35,670,19.1,5,darius-slayton-1
19,Jaylen Waddle*,Alabama,SEC,15,45,848,18.8,7,0,0,,0,45,848,18.8,7,jaylen-waddle-1
20,Joe Reed*,Virginia,ACC,13,25,465,18.6,7,3,15,5.0,0,28,480,17.1,7,joe-reed-4
21,Michael Pittman Jr.,USC,Pac-12,11,41,758,18.5,6,1,9,9.0,0,42,767,18.3,6,michael-pittman-jr-1
22,Jaylen Dixon*,Utah,Pac-12,14,32,589,18.4,2,1,-3,-3.0,0,33,586,17.8,2,jaylen-dixon-1
23,Tre Walker,San Jose State,MWC,9,39,714,18.3,5,1,0,0.0,0,40,714,17.9,5,tre-walker-3
24,Rashad Medaris*,Cincinnati,American,12,26,472,18.2,3,0,0,,0,26,472,18.2,3,rashad-medaris-1
25,Shawn Poindexter,Arizona,Pac-12,12,42,759,18.1,11,0,0,,0,42,759,18.1,11,shawn-poindexter-1
26,Tony Ellison,Arizona,Pac-12,12,29,525,18.1,6,1,-7,-7.0,0,30,518,17.3,6,tony-ellison-1
27,KJ Hamler*,Penn State,Big Ten,13,42,754,18.0,5,4,44,11.0,1,46,798,17.3,6,kj-hamler-1
28,CeeDee Lamb*,Oklahoma,Big 12,14,65,1158,17.8,11,0,0,,0,65,1158,17.8,11,ceedee-lamb-1
29,Jamal Custis*,Syracuse,ACC,13,51,906,17.8,6,1,-5,-5.0,0,52,901,17.3,6,jamal-custis-1
30,Anthony Johnson*,Buffalo,MAC,13,57,1011,17.7,11,0,0,,0,57,1011,17.7,11,anthony-johnson-13
31,Marquise Brown*,Oklahoma,Big 12,14,75,1318,17.6,10,2,0,0.0,0,77,1318,17.1,10,marquise-brown-1
32,Corey Sutton*,Appalachian State,Sun Belt,13,44,773,17.6,10,0,0,,0,44,773,17.6,10,corey-sutton-2
33,Aaren Vaughns*,Utah State,MWC,13,33,581,17.6,5,12,100,8.3,0,45,681,15.1,5,aaren-vaughns-1
34,Matt Bushman*,Brigham Young,Ind,13,29,511,17.6,2,0,0,,0,29,511,17.6,2,matt-bushman-1
35,Darnell Salomon*,South Florida,American,10,25,440,17.6,4,0,0,,0,25,440,17.6,4,darnell-salomon-1
36,McLane Mannix*,Nevada,MWC,12,50,875,17.5,7,3,25,8.3,0,53,900,17.0,7,mclane-mannix-1
37,Tylan Wallace*,Oklahoma State,Big 12,13,86,1491,17.3,12,1,6,6.0,1,87,1497,17.2,13,tylan-wallace-1
38,Jace Sternberger*,Texas A&M,SEC,13,48,832,17.3,10,1,4,4.0,0,49,836,17.1,10,jace-sternberger-1
39,Keith Corbin*,Houston,American,12,40,691,17.3,10,4,5,1.3,0,44,696,15.8,10,keith-corbin-1
40,Travis Fulgham,Old Dominion,CUSA,12,63,1083,17.2,9,0,0,,0,63,1083,17.2,9,travis-fulgham-1
41,Marcus Green,Louisiana-Monroe,Sun Belt,12,50,855,17.1,8,20,193,9.7,1,70,1048,15.0,9,marcus-green-6
42,Brycen Hopkins*,Purdue,Big Ten,13,34,583,17.1,2,0,0,,0,34,583,17.1,2,brycen-hopkins-1
43,Gary Jennings*,West Virginia,Big 12,11,54,917,17.0,13,0,0,,0,54,917,17.0,13,gary-jennings-1
44,JoJo Ward*,Hawaii,MWC,14,51,865,17.0,9,0,0,,0,51,865,17.0,9,jojo-ward-1
45,C.J. Worton*,Florida International,CUSA,13,37,627,16.9,6,0,0,,0,37,627,16.9,6,cj-worton-1
46,Chatarius Atwell,Louisville,ACC,12,24,406,16.9,2,1,-5,-5.0,0,25,401,16.0,2,chatarius-atwell-1
47,JJ Arcega-Whiteside*,Stanford,Pac-12,12,63,1059,16.8,14,0,0,,0,63,1059,16.8,14,jj-arcega-whiteside-1
48,K.J. Osborn*,Buffalo,MAC,14,53,892,16.8,7,5,16,3.2,0,58,908,15.7,7,kj-osborn-1
49,Colby Parkinson*,Stanford,Pac-12,13,29,485,16.7,7,0,0,,0,29,485,16.7,7,colby-parkinson-1
50,Terry Wright*,Purdue,Big Ten,13,28,468,16.7,5,1,1,1.0,1,29,469,16.2,6,terry-wright-2
51,Andy Isabella,Massachusetts,Ind,12,102,1698,16.6,13,11,79,7.2,1,113,1777,15.7,14,andy-isabella-1
52,Nico Collins*,Michigan,Big Ten,13,38,632,16.6,6,0,0,,0,38,632,16.6,6,nico-collins-1
53,La'Michael Pettway,Arkansas,SEC,12,30,499,16.6,4,0,0,,0,30,499,16.6,4,lamichael-pettway-1
54,Terren Encalade*,Tulane,American,13,44,727,16.5,5,5,56,11.2,0,49,783,16.0,5,terren-encalade-1
55,DeVonta Smith*,Alabama,SEC,14,42,693,16.5,6,0,0,,0,42,693,16.5,6,devonta-smith-1
56,Andre Wilson*,UAB,CUSA,14,32,529,16.5,5,7,104,14.9,1,39,633,16.2,6,andre-wilson-1
57,Anthony Ratliff-Williams,North Carolina,ACC,11,42,689,16.4,2,11,83,7.5,1,53,772,14.6,3,anthony-ratliff-williams-1
58,Osirus Mitchell*,Mississippi State,SEC,13,26,427,16.4,4,0,0,,0,26,427,16.4,4,osirus-mitchell-1
59,Damonte Coxie*,Memphis,American,14,72,1174,16.3,7,0,0,,0,72,1174,16.3,7,damonte-coxie-1
60,Kwadarrius Smith,Akron,MAC,11,33,538,16.3,3,8,24,3.0,0,41,562,13.7,3,kwadarrius-smith-1
61,A.J. Taylor*,Wisconsin,Big Ten,13,32,521,16.3,3,0,0,,0,32,521,16.3,3,aj-taylor-1
62,Dalton Schoen,Kansas State,Big 12,11,32,520,16.3,2,0,0,,0,32,520,16.3,2,dalton-schoen-1
63,John Hightower,Boise State,MWC,10,31,504,16.3,6,8,163,20.4,2,39,667,17.1,8,john-hightower-1
64,Scott Miller,Bowling Green State,MAC,11,71,1148,16.2,9,4,16,4.0,0,75,1164,15.5,9,scott-miller-3
65,Justin Jefferson*,LSU,SEC,13,54,875,16.2,6,5,26,5.2,0,59,901,15.3,6,justin-jefferson-1
66,Isaac Zico*,Purdue,Big Ten,13,46,743,16.2,6,0,0,,0,46,743,16.2,6,isaac-zico-1
67,Caleb Wilson,UCLA,Pac-12,12,60,965,16.1,4,1,4,4.0,0,61,969,15.9,4,caleb-wilson-2
68,Henry Ruggs III*,Alabama,SEC,15,46,741,16.1,11,0,0,,0,46,741,16.1,11,henry-ruggs-iii-1
69,Irv Smith Jr.*,Alabama,SEC,15,44,710,16.1,7,0,0,,0,44,710,16.1,7,irv-smith-jr-1
70,Jeff Thomas*,Miami (FL),ACC,11,35,563,16.1,3,1,19,19.0,0,36,582,16.2,3,jeff-thomas-6
71,Zach Gentry*,Michigan,Big Ten,13,32,514,16.1,2,0,0,,0,32,514,16.1,2,zach-gentry-2
72,Jamire Jordan*,Fresno State,MWC,14,27,434,16.1,3,0,0,,0,27,434,16.1,3,jamire-jordan-1
73,Antoine Wesley,Texas Tech,Big 12,12,88,1410,16.0,9,1,-2,-2.0,0,89,1408,15.8,9,antoine-wesley-1
74,Dredrick Snelson*,UCF,American,12,43,688,16.0,5,1,4,4.0,0,44,692,15.7,5,dredrick-snelson-1
75,Marquez Callaway,Tennessee,SEC,12,37,592,16.0,2,0,0,,0,37,592,16.0,2,marquez-callaway-1
76,Jacquez Sloan,Western Kentucky,CUSA,9,31,495,16.0,0,2,4,2.0,0,33,499,15.1,0,jacquez-sloan-1
77,Chris Autman-Bell*,Minnesota,Big Ten,13,28,449,16.0,0,0,0,,0,28,449,16.0,0,chris-autman-bell-1
78,Keith Gavin,Florida State,ACC,12,26,415,16.0,1,0,0,,0,26,415,16.0,1,keith-gavin-1
79,Papi White*,Ohio,MAC,13,62,987,15.9,9,3,24,8.0,1,65,1011,15.6,10,papi-white-1
80,Tee Higgins*,Clemson,ACC,15,59,936,15.9,12,0,0,,0,59,936,15.9,12,tee-higgins-1
81,Tyron Johnson*,Oklahoma State,Big 12,13,53,845,15.9,7,1,1,1.0,1,54,846,15.7,8,tyron-johnson-1
82,Johnnie Dixon*,Ohio State,Big Ten,14,42,669,15.9,8,0,0,,0,42,669,15.9,8,johnnie-dixon-1
83,Kobay White,Boston College,ACC,12,33,526,15.9,3,5,0,0.0,0,38,526,13.8,3,kobay-white-1
84,Dillon Mitchell*,Oregon,Pac-12,13,75,1184,15.8,10,1,5,5.0,0,76,1189,15.6,10,dillon-mitchell-1
85,Ty Jones*,Washington,Pac-12,13,31,491,15.8,6,0,0,,0,31,491,15.8,6,ty-jones-3
86,Ty Jones*,Washington,Pac-12,14,31,491,15.8,6,0,0,,0,31,491,15.8,6,ty-jones-4
87,Damon Hazelton Jr.*,Virginia Tech,ACC,13,51,802,15.7,8,1,4,4.0,0,52,806,15.5,8,damon-hazelton-jr-1
88,Jalen Greene*,Utah State,MWC,13,44,689,15.7,6,0,0,,0,44,689,15.7,6,jalen-greene-1
89,Damion Willis*,Troy,Sun Belt,11,56,876,15.6,10,0,0,,0,56,876,15.6,10,damion-willis-1
90,Mecole Hardman*,Georgia,SEC,14,34,532,15.6,7,5,36,7.2,0,39,568,14.6,7,mecole-hardman-1
91,A.J. Brown,Ole Miss,SEC,12,85,1320,15.5,6,0,0,,0,85,1320,15.5,6,aj-brown-3
92,Jared Pinkney*,Vanderbilt,SEC,13,50,774,15.5,7,0,0,,0,50,774,15.5,7,jared-pinkney-1
93,Diontae Johnson*,Toledo,MAC,13,49,761,15.5,8,2,17,8.5,0,51,778,15.3,8,diontae-johnson-1
94,T.J. Hockenson*,Iowa,Big Ten,13,49,760,15.5,6,1,4,4.0,1,50,764,15.3,7,tj-hockenson-1
95,Delane Hart-Johnson,New Mexico,MWC,12,33,512,15.5,5,0,0,,0,33,512,15.5,5,delane-hart-johnson-1
96,Jalen Knox*,Missouri,SEC,10,27,419,15.5,3,3,11,3.7,0,30,430,14.3,3,jalen-knox-1
97,Jalen Knox*,Missouri,SEC,13,27,419,15.5,3,3,11,3.7,0,30,430,14.3,3,jalen-knox-2
98,Bryan Edwards*,South Carolina,SEC,13,55,846,15.4,7,0,0,,0,55,846,15.4,7,bryan-edwards-1
99,Gabriel Davis*,UCF,American,12,53,815,15.4,7,0,0,,0,53,815,15.4,7,gabriel-davis-1
100,Reggie Roberson Jr.,SMU,American,10,52,802,15.4,6,3,10,3.3,0,55,812,14.8,6,reggie-roberson-jr-1
101,Malcolm Williams,Coastal Carolina,Sun Belt,12,47,724,15.4,5,10,22,2.2,1,57,746,13.1,6,malcolm-williams-4
102,Courtney Lark*,Houston,American,9,35,539,15.4,5,0,0,,0,35,539,15.4,5,courtney-lark-1
103,Adrian Hardy*,Louisiana Tech,CUSA,13,75,1145,15.3,6,0,0,,0,75,1145,15.3,6,adrian-hardy-1
104,A.J. Richardson,Boise State,MWC,13,54,825,15.3,8,0,0,,0,54,825,15.3,8,aj-richardson-1
105,Jaylen Smith,Louisville,ACC,12,36,550,15.3,1,0,0,,0,36,550,15.3,1,jaylen-smith-1
106,Felton Davis III*,Michigan State,Big Ten,7,31,474,15.3,4,2,50,25.0,1,33,524,15.9,5,felton-davis-iii-1
107,Ky'Jon Tyler,Coastal Carolina,Sun Belt,11,26,397,15.3,2,3,44,14.7,1,29,441,15.2,3,kyjon-tyler-1
108,Trevon Brown,East Carolina,American,12,74,1123,15.2,9,1,-2,-2.0,0,75,1121,14.9,9,trevon-brown-1
109,David Sills*,West Virginia,Big 12,12,65,986,15.2,15,0,14,,0,65,1000,15.4,15,david-sills-1
110,Marcus Simms*,West Virginia,Big 12,11,46,699,15.2,2,1,5,5.0,0,47,704,15.0,2,marcus-simms-1
111,Ja'Marcus Bradley*,Louisiana,Sun Belt,14,40,608,15.2,10,1,5,5.0,0,41,613,15.0,10,jamarcus-bradley-1
112,James Price,Wyoming,MWC,12,26,395,15.2,1,2,10,5.0,0,28,405,14.5,1,james-price-3
113,John Ursua*,Hawaii,MWC,13,89,1343,15.1,16,2,4,2.0,1,91,1347,14.8,17,john-ursua-1
114,Aaron Fuller*,Washington,Pac-12,14,58,874,15.1,4,0,0,,0,58,874,15.1,4,aaron-fuller-1
115,Kyle Buss,Connecticut,American,12,32,482,15.1,3,0,0,,0,32,482,15.1,3,kyle-buss-1
116,Tyler Johnson*,Minnesota,Big Ten,13,78,1169,15.0,12,0,0,,0,78,1169,15.0,12,tyler-johnson-6
117,Rico Bussey Jr.*,North Texas,CUSA,12,68,1017,15.0,12,0,0,,0,68,1017,15.0,12,rico-bussey-jr-1
118,Shi Smith*,South Carolina,SEC,12,45,673,15.0,4,0,0,,0,45,673,15.0,4,shi-smith-1
119,Kawaan Baker,South Alabama,Sun Belt,12,33,494,15.0,4,59,251,4.3,9,92,745,8.1,13,kawaan-baker-1
120,Sadiq Palmer,Massachusetts,Ind,12,28,419,15.0,2,0,0,,0,28,419,15.0,2,sadiq-palmer-1
121,N'Keal Harry*,Arizona State,Pac-12,12,73,1088,14.9,9,7,10,1.4,1,80,1098,13.7,10,nkeal-harry-1
122,Jalen Guyton*,North Texas,CUSA,13,54,805,14.9,6,0,0,,0,54,805,14.9,6,jalen-guyton-1
123,Isaiah Hodgins,Oregon State,Pac-12,11,59,876,14.8,5,0,0,,0,59,876,14.8,5,isaiah-hodgins-1
124,Miles Boykin*,Notre Dame,Ind,13,59,872,14.8,8,0,0,,0,59,872,14.8,8,miles-boykin-1
125,Darren Woods Jr.,UNLV,MWC,11,24,355,14.8,5,0,0,,0,24,355,14.8,5,darren-woods-jr-1
126,Jalen Reagor*,TCU,Big 12,13,72,1061,14.7,9,13,170,13.1,2,85,1231,14.5,11,jalen-reagor-1
127,Olabisi Johnson,Colorado State,MWC,11,54,796,14.7,4,0,0,,0,54,796,14.7,4,olabisi-johnson-1
128,Harrison Bryant,Florida Atlantic,CUSA,12,45,662,14.7,4,1,2,2.0,0,46,664,14.4,4,harrison-bryant-1
129,Maurice Ffrench*,Pitt,ACC,14,35,515,14.7,6,19,164,8.6,2,54,679,12.6,8,maurice-ffrench-1
130,Jonah Morris,Akron,MAC,9,26,381,14.7,1,1,1,1.0,0,27,382,14.1,1,jonah-morris-1
131,Jonah Morris,Akron,MAC,12,26,381,14.7,1,1,1,1.0,0,27,382,14.1,1,jonah-morris-2
132,Kelvin Harmon*,North Carolina State,ACC,12,81,1186,14.6,7,0,0,,0,81,1186,14.6,7,kelvin-harmon-1
133,Antonio Gandy-Golden,Liberty,Ind,11,71,1037,14.6,10,0,0,,0,71,1037,14.6,10,antonio-gandy-golden-1
134,Alex Bachman*,Wake Forest,ACC,12,37,541,14.6,6,0,0,,0,37,541,14.6,6,alex-bachman-1
135,RJ Turner,Louisiana-Monroe,Sun Belt,11,36,526,14.6,1,0,0,,0,36,526,14.6,1,rj-turner-1
136,Jauan Jennings,Tennessee,SEC,12,30,438,14.6,3,0,0,,0,30,438,14.6,3,jauan-jennings-1
137,Collin Johnson*,Texas,Big 12,13,68,985,14.5,7,0,0,,0,68,985,14.5,7,collin-johnson-2
138,Omar Bayless*,Arkansas State,Sun Belt,12,39,566,14.5,2,0,0,,0,39,566,14.5,2,omar-bayless-1
139,Sean Modster,Boise State,MWC,13,68,978,14.4,8,0,0,,0,68,978,14.4,8,sean-modster-1
140,Riley Miller,Ball State,MAC,12,61,878,14.4,7,0,0,,0,61,878,14.4,7,riley-miller-1
141,Denzel Mims*,Baylor,Big 12,12,55,794,14.4,8,0,0,,0,55,794,14.4,8,denzel-mims-1
142,Van Jefferson*,Florida,SEC,13,35,503,14.4,6,0,0,,0,35,503,14.4,6,van-jefferson-1
143,Brandon Aiyuk*,Arizona State,Pac-12,13,33,474,14.4,3,0,0,,0,33,474,14.4,3,brandon-aiyuk-1
144,Stanley Morgan Jr.,Nebraska,Big Ten,12,70,1004,14.3,7,1,4,4.0,0,71,1008,14.2,7,stanley-morgan-jr-1
145,Isaac Nauta*,Georgia,SEC,14,30,430,14.3,3,0,31,,1,30,461,15.4,4,isaac-nauta-1
146,Deebo Samuel*,South Carolina,SEC,12,62,882,14.2,11,8,26,3.3,0,70,908,13.0,11,deebo-samuel-1
147,Jayden Reed*,Western Michigan,MAC,13,56,797,14.2,8,1,-9,-9.0,0,57,788,13.8,8,jayden-reed-1
148,Sage Surratt*,Wake Forest,ACC,13,41,581,14.2,4,0,0,,0,41,581,14.2,4,sage-surratt-1
149,Chris Platt*,Baylor,Big 12,13,36,511,14.2,1,2,31,15.5,0,38,542,14.3,1,chris-platt-1
150,Pat Freiermuth*,Penn State,Big Ten,13,26,368,14.2,8,0,0,,0,26,368,14.2,8,pat-freiermuth-1
151,KeeSean Johnson*,Fresno State,MWC,14,95,1340,14.1,8,4,14,3.5,0,99,1354,13.7,8,keesean-johnson-1
152,Jonathan Duhart,Old Dominion,CUSA,12,74,1045,14.1,9,0,0,,0,74,1045,14.1,9,jonathan-duhart-1
153,Tyre Brady*,Marshall,CUSA,13,71,1002,14.1,9,1,14,14.0,0,72,1016,14.1,9,tyre-brady-1
154,Andre Williams,Akron,MAC,11,46,649,14.1,6,1,4,4.0,0,47,653,13.9,6,andre-williams-5
155,Aaron Cephus,Rice,CUSA,11,40,565,14.1,5,0,0,,0,40,565,14.1,5,aaron-cephus-1
156,Taj Harris*,Syracuse,ACC,12,40,565,14.1,3,0,0,,0,40,565,14.1,3,taj-harris-1
157,Tre Nixon*,UCF,American,13,40,562,14.1,4,0,0,,0,40,562,14.1,4,tre-nixon-1
158,Cornelius McCoy,Georgia State,Sun Belt,12,35,495,14.1,1,0,0,,0,35,495,14.1,1,cornelius-mccoy-1
159,KaVontae Turpin*,TCU,Big 12,7,29,410,14.1,3,4,32,8.0,0,33,442,13.4,3,kavontae-turpin-1
160,Trevon Wesco*,West Virginia,Big 12,12,26,366,14.1,1,1,3,3.0,0,27,369,13.7,1,trevon-wesco-1
161,Juwan Johnson*,Penn State,Big Ten,10,25,352,14.1,1,0,0,,0,25,352,14.1,1,juwan-johnson-1
162,Preston Williams,Colorado State,MWC,12,96,1345,14.0,14,4,13,3.3,0,100,1358,13.6,14,preston-williams-4
163,Jamarius Way,South Alabama,Sun Belt,12,61,855,14.0,8,1,1,1.0,0,62,856,13.8,8,jamarius-way-1
164,Kahlil Lewis*,Cincinnati,American,13,56,782,14.0,9,1,11,11.0,1,57,793,13.9,10,kahlil-lewis-1
165,Jack Sorenson,Miami (OH),MAC,12,53,742,14.0,2,0,0,,0,53,742,14.0,2,jack-sorenson-1
166,Nick Westbrook,Indiana,Big Ten,12,42,590,14.0,4,0,0,,0,42,590,14.0,4,nick-westbrook-1
167,Keylon Stokes,Tulsa,American,12,41,575,14.0,2,15,104,6.9,2,56,679,12.1,4,keylon-stokes-1
168,Andrew Meyer*,Ohio,MAC,13,36,505,14.0,5,0,0,,0,36,505,14.0,5,andrew-meyer-1
169,Collin Lisa*,UAB,CUSA,14,33,462,14.0,1,0,0,,0,33,462,14.0,1,collin-lisa-1
170,Trevon Grimes*,Florida,SEC,13,26,364,14.0,2,0,0,,0,26,364,14.0,2,trevon-grimes-1
171,Camron Buckley*,Texas A&M,SEC,13,34,474,13.9,1,0,0,,0,34,474,13.9,1,camron-buckley-1
172,Trey Hartley,San Jose State,MWC,12,32,446,13.9,3,1,-10,-10.0,0,33,436,13.2,3,trey-hartley-1
173,Cameron Odom*,Ohio,MAC,13,30,418,13.9,2,0,0,,0,30,418,13.9,2,cameron-odom-1
174,Nyqwan Murray,Florida State,ACC,12,54,744,13.8,3,5,4,0.8,0,59,748,12.7,3,nyqwan-murray-1
175,Rashod Bateman*,Minnesota,Big Ten,13,51,704,13.8,6,0,0,,0,51,704,13.8,6,rashod-bateman-1
176,Nykeim Johnson*,Syracuse,ACC,12,41,565,13.8,4,4,9,2.3,0,45,574,12.8,4,nykeim-johnson-1
177,Lil'Jordan Humphrey*,Texas,Big 12,14,86,1176,13.7,9,6,25,4.2,1,92,1201,13.1,10,liljordan-humphrey-1
178,Jalen Hurd*,Baylor,Big 12,12,69,946,13.7,4,48,209,4.4,3,117,1155,9.9,7,jalen-hurd-1
179,Penny Hart,Georgia State,Sun Belt,12,49,669,13.7,2,4,-10,-2.5,0,53,659,12.4,2,penny-hart-1
180,Branden Mack*,Temple,American,13,44,601,13.7,5,0,0,,0,44,601,13.7,5,branden-mack-1
181,B.J. Farrow,Liberty,Ind,11,40,546,13.7,5,1,-8,-8.0,0,41,538,13.1,5,bj-farrow-1
182,Marquez Stevenson*,Houston,American,13,75,1019,13.6,9,14,126,9.0,2,89,1145,12.9,11,marquez-stevenson-1
183,Dez Fitzpatrick,Louisville,ACC,12,31,422,13.6,3,0,0,,0,31,422,13.6,3,dez-fitzpatrick-1
184,Tyleek Collins,UNLV,MWC,12,31,422,13.6,6,12,104,8.7,1,43,526,12.2,7,tyleek-collins-1
185,DaMarkus Lodge,Ole Miss,SEC,11,65,877,13.5,4,0,0,,0,65,877,13.5,4,damarkus-lodge-1
186,Ventell Bryant*,Temple,American,13,51,690,13.5,3,3,12,4.0,0,54,702,13.0,3,ventell-bryant-1
187,Cody Thompson*,Toledo,MAC,13,48,647,13.5,10,0,0,,0,48,647,13.5,10,cody-thompson-1
188,Kaden Smith*,Stanford,Pac-12,10,47,635,13.5,2,0,0,,0,47,635,13.5,2,kaden-smith-1
189,Michael Lawrence*,North Texas,CUSA,13,32,433,13.5,2,0,0,,0,32,433,13.5,2,michael-lawrence-1
190,Chris Taylor*,Duke,ACC,13,31,419,13.5,3,0,0,,0,31,419,13.5,3,chris-taylor-4
191,Jovon Durante,Florida Atlantic,CUSA,12,65,873,13.4,5,8,39,4.9,0,73,912,12.5,5,jovon-durante-1
192,Dezmon Patmon*,Washington State,Pac-12,13,61,816,13.4,5,0,0,,0,61,816,13.4,5,dezmon-patmon-1
193,Theo Howard,UCLA,Pac-12,12,51,677,13.3,4,3,26,8.7,0,54,703,13.0,4,theo-howard-1
194,Mike Carrigan,Kent State,MAC,12,45,597,13.3,5,0,0,,0,45,597,13.3,5,mike-carrigan-1
195,Eric Kumah*,Virginia Tech,ACC,12,42,559,13.3,7,1,0,0.0,0,43,559,13.0,7,eric-kumah-1
196,Devin Duvernay*,Texas,Big 12,14,41,546,13.3,4,1,10,10.0,0,42,556,13.2,4,devin-duvernay-1
197,Noah Fant*,Iowa,Big Ten,12,39,519,13.3,7,2,1,0.5,0,41,520,12.7,7,noah-fant-1
198,Drew Dan,New Mexico State,Ind,12,37,491,13.3,3,0,0,,0,37,491,13.3,3,drew-dan-1
199,CJ O'Grady,Arkansas,SEC,10,30,400,13.3,6,0,0,,0,30,400,13.3,6,cj-ogrady-1
200,Victor Tucker,Charlotte,CUSA,11,54,712,13.2,2,0,0,,0,54,712,13.2,2,victor-tucker-1
201,Cody White*,Michigan State,Big Ten,9,42,555,13.2,2,1,22,22.0,1,43,577,13.4,3,cody-white-3
202,Josh Hammond*,Florida,SEC,13,28,369,13.2,4,2,32,16.0,1,30,401,13.4,5,josh-hammond-1
203,Keishawn Watson*,Western Michigan,MAC,12,25,330,13.2,2,0,0,,0,25,330,13.2,2,keishawn-watson-1
204,DeAndre Thompkins*,Penn State,Big Ten,13,25,329,13.2,2,0,0,,0,25,329,13.2,2,deandre-thompkins-1
205,Seth Dawkins,Louisville,ACC,11,25,329,13.2,1,0,0,,0,25,329,13.2,1,seth-dawkins-1
206,Romeo Doubs*,Nevada,MWC,13,43,562,13.1,2,0,0,,0,43,562,13.1,2,romeo-doubs-1
207,Ty Fryfogle,Indiana,Big Ten,12,29,381,13.1,3,0,0,,0,29,381,13.1,3,ty-fryfogle-1
208,Taivon Jacobs,Maryland,Big Ten,12,25,328,13.1,2,12,38,3.2,0,37,366,9.9,2,taivon-jacobs-1
209,Armani Levias*,Marshall,CUSA,13,25,327,13.1,3,0,0,,0,25,327,13.1,3,armani-levias-1
210,Ja'Deion High,Texas Tech,Big 12,12,62,804,13.0,4,0,0,,0,62,804,13.0,4,jadeion-high-1
211,Donovan Peoples-Jones*,Michigan,Big Ten,13,47,612,13.0,8,3,37,12.3,0,50,649,13.0,8,donovan-peoples-jones-1
212,Quartney Davis*,Texas A&M,SEC,13,45,585,13.0,7,3,13,4.3,0,48,598,12.5,7,quartney-davis-1
213,Riley Ridley*,Georgia,SEC,14,44,570,13.0,9,0,0,,0,44,570,13.0,9,riley-ridley-1
214,CT Thomas,Boise State,MWC,13,41,535,13.0,3,4,45,11.3,0,45,580,12.9,3,ct-thomas-1
215,James Proche,SMU,American,12,93,1199,12.9,12,2,17,8.5,0,95,1216,12.8,12,james-proche-1
216,Arthur Jackson III*,Eastern Michigan,MAC,13,46,592,12.9,5,0,0,,0,46,592,12.9,5,arthur-jackson-iii-1
217,C.J. Bolar*,Vanderbilt,SEC,13,34,440,12.9,2,2,24,12.0,0,36,464,12.9,2,cj-bolar-1
218,Keenen Johnson,Tulsa,American,12,34,438,12.9,4,0,0,,0,34,438,12.9,4,keenen-johnson-1
219,Brandon Smith*,Iowa,Big Ten,12,28,361,12.9,2,0,0,,0,28,361,12.9,2,brandon-smith-11
220,Chase Claypool*,Notre Dame,Ind,13,50,639,12.8,4,0,0,,0,50,639,12.8,4,chase-claypool-1
221,Aleva Hifo*,Brigham Young,Ind,13,28,358,12.8,2,30,129,4.3,2,58,487,8.4,4,aleva-hifo-1
222,Dax Raymond*,Utah State,MWC,11,27,345,12.8,2,1,0,0.0,0,28,345,12.3,2,dax-raymond-1
223,Khari Blasingame*,Vanderbilt,SEC,13,25,320,12.8,1,96,401,4.2,5,121,721,6.0,6,khari-blasingame-1
224,Josh Oliver,San Jose State,MWC,12,56,709,12.7,4,0,0,,0,56,709,12.7,4,josh-oliver-1
225,T.J. Vasher,Texas Tech,Big 12,11,54,687,12.7,7,0,0,,0,54,687,12.7,7,tj-vasher-1
226,Jake Ferguson*,Wisconsin,Big Ten,13,36,456,12.7,4,0,0,,0,36,456,12.7,4,jake-ferguson-1
227,Warren Jackson,Colorado State,MWC,10,32,405,12.7,4,0,0,,0,32,405,12.7,4,warren-jackson-2
228,Bryce Singleton*,Florida International,CUSA,10,29,368,12.7,2,0,0,,0,29,368,12.7,2,bryce-singleton-1
229,K.J. Hill*,Ohio State,Big Ten,14,70,885,12.6,6,1,-3,-3.0,0,71,882,12.4,6,kj-hill-1
230,Blake Banham*,Eastern Michigan,MAC,13,60,758,12.6,5,8,32,4.0,1,68,790,11.6,6,blake-banham-1
231,Easop Winston*,Washington State,Pac-12,13,52,654,12.6,8,0,0,,0,52,654,12.6,8,easop-winston-1
232,D.J. Stubbs,Liberty,Ind,12,50,631,12.6,1,0,0,,0,50,631,12.6,1,dj-stubbs-1
233,Dillon Stoner*,Oklahoma State,Big 12,12,48,603,12.6,2,0,0,,0,48,603,12.6,2,dillon-stoner-1
234,Mitchell Wilcox*,South Florida,American,12,43,540,12.6,2,0,0,,0,43,540,12.6,2,mitchell-wilcox-1
235,Amon-Ra St. Brown,USC,Pac-12,12,60,750,12.5,3,2,9,4.5,0,62,759,12.2,3,amon-ra-st-brown-1
236,Johnathon Johnson*,Missouri,SEC,13,59,737,12.5,5,1,8,8.0,0,60,745,12.4,5,johnathon-johnson-2
237,Ben Skowronek*,Northwestern,Big Ten,14,45,562,12.5,3,0,0,,0,45,562,12.5,3,ben-skowronek-1
238,Ty Lee*,Middle Tennessee State,CUSA,14,71,883,12.4,7,4,18,4.5,0,75,901,12.0,7,ty-lee-1
239,JD Spielman,Nebraska,Big Ten,10,66,818,12.4,8,7,24,3.4,0,73,842,11.5,8,jd-spielman-1
240,Brandon Presley,UNLV,MWC,12,35,434,12.4,3,1,-10,-10.0,0,36,424,11.8,3,brandon-presley-1
241,Romello Brooker*,Houston,American,13,33,409,12.4,7,0,0,,0,33,409,12.4,7,romello-brooker-1
242,Aaron McLean,Connecticut,American,12,32,396,12.4,2,0,0,,0,32,396,12.4,2,aaron-mclean-1
243,Deondre Farrier,East Carolina,American,7,30,372,12.4,2,1,0,0.0,0,31,372,12.0,2,deondre-farrier-1
244,Kendrick Rogers*,Texas A&M,SEC,12,27,336,12.4,5,0,0,,0,27,336,12.4,5,kendrick-rogers-1
245,Cedric Byrd*,Hawaii,MWC,14,79,970,12.3,9,0,0,,0,79,970,12.3,9,cedric-byrd-1
246,Quez Watkins,Southern Mississippi,CUSA,11,72,889,12.3,9,4,11,2.8,0,76,900,11.8,9,quez-watkins-1
247,Justin McInnis*,Arkansas State,Sun Belt,13,61,748,12.3,5,1,-11,-11.0,0,62,737,11.9,5,justin-mcinnis-1
248,Quintin Morris,Bowling Green State,MAC,12,42,516,12.3,7,1,7,7.0,0,43,523,12.2,7,quintin-morris-1
249,Justin Hobbs,Tulsa,American,12,39,480,12.3,3,0,0,,0,39,480,12.3,3,justin-hobbs-1
250,Josiah Deguara*,Cincinnati,American,13,38,468,12.3,5,0,0,,0,38,468,12.3,5,josiah-deguara-1
251,Warren Redix,UTEP,CUSA,11,36,442,12.3,0,0,0,,0,36,442,12.3,0,warren-redix-1
252,Tarique Milton*,Iowa State,Big 12,13,34,417,12.3,1,1,3,3.0,0,35,420,12.0,1,tarique-milton-1
253,Ricky Smalling,Illinois,Big Ten,11,33,406,12.3,5,0,0,,0,33,406,12.3,5,ricky-smalling-1
254,Hezekiah Grimsley*,Virginia Tech,ACC,11,31,382,12.3,1,12,75,6.3,1,43,457,10.6,2,hezekiah-grimsley-1
255,Kanawai Noa*,California,Pac-12,9,30,369,12.3,2,1,6,6.0,0,31,375,12.1,2,kanawai-noa-1
256,Brad Anderson*,Middle Tennessee State,CUSA,6,27,332,12.3,0,23,122,5.3,1,50,454,9.1,1,brad-anderson-3
257,K.D. Nixon,Colorado,Pac-12,11,52,636,12.2,4,9,-8,-0.9,1,61,628,10.3,5,kd-nixon-1
258,Dalton Keene*,Virginia Tech,ACC,12,28,341,12.2,3,0,0,,0,28,341,12.2,3,dalton-keene-1
259,T.J. Simmons*,West Virginia,Big 12,12,28,341,12.2,1,0,0,,0,28,341,12.2,1,tj-simmons-4
260,Greg Dortch*,Wake Forest,ACC,12,89,1078,12.1,8,5,20,4.0,0,94,1098,11.7,8,greg-dortch-1
261,Kirk Merritt*,Arkansas State,Sun Belt,13,83,1005,12.1,7,5,31,6.2,0,88,1036,11.8,7,kirk-merritt-1
262,Johnathan Boone,New Mexico State,Ind,12,59,715,12.1,3,2,-9,-4.5,0,61,706,11.6,3,johnathan-boone-1
263,Jared Rice*,Fresno State,MWC,14,55,664,12.1,3,1,3,3.0,0,56,667,11.9,3,jared-rice-1
264,Donavan Hale,Indiana,Big Ten,12,42,508,12.1,6,0,0,,0,42,508,12.1,6,donavan-hale-1
265,Tim Jones,Southern Mississippi,CUSA,11,42,508,12.1,1,3,11,3.7,0,45,519,11.5,1,tim-jones-8
266,Jhamon Ausbon*,Texas A&M,SEC,9,31,375,12.1,0,0,0,,0,31,375,12.1,0,jhamon-ausbon-1
267,Jaelon Darden*,North Texas,CUSA,13,48,575,12.0,4,3,16,5.3,0,51,591,11.6,4,jaelon-darden-1
268,Mik'Quan Deane,Western Kentucky,CUSA,12,44,530,12.0,6,3,2,0.7,0,47,532,11.3,6,mikquan-deane-1
269,Obi Obialo*,Marshall,CUSA,13,42,505,12.0,4,0,0,,0,42,505,12.0,4,obi-obialo-1
270,Kahale Warring*,San Diego State,MWC,12,31,372,12.0,3,0,0,,0,31,372,12.0,3,kahale-warring-1
271,Trestan Ebner*,Baylor,Big 12,13,29,348,12.0,1,69,413,6.0,1,98,761,7.8,2,trestan-ebner-1
272,Isaiah Zuber,Kansas State,Big 12,12,52,619,11.9,5,1,17,17.0,0,53,636,12.0,5,isaiah-zuber-1
273,Austin Walter,Rice,CUSA,13,44,525,11.9,2,133,564,4.2,4,177,1089,6.2,6,austin-walter-1
274,Ryheem Malone*,Louisiana,Sun Belt,14,44,525,11.9,4,7,21,3.0,0,51,546,10.7,4,ryheem-malone-1
275,Maurice Alexander*,Florida International,CUSA,13,40,474,11.9,5,17,115,6.8,2,57,589,10.3,7,maurice-alexander-2
276,Parris Campbell*,Ohio State,Big Ten,14,90,1063,11.8,12,9,24,2.7,0,99,1087,11.0,12,parris-campbell-1
277,Laviska Shenault Jr.,Colorado,Pac-12,9,86,1011,11.8,6,17,115,6.8,5,103,1126,10.9,11,laviska-shenault-jr-1
278,Sean Riley*,Syracuse,ACC,13,64,756,11.8,3,5,37,7.4,0,69,793,11.5,3,sean-riley-2
279,Johnathan Lloyd*,Duke,ACC,13,51,604,11.8,5,2,4,2.0,0,53,608,11.5,5,johnathan-lloyd-1
280,Jamire Calvin*,Washington State,Pac-12,13,42,497,11.8,1,0,0,,0,42,497,11.8,1,jamire-calvin-1
281,RB Marlow III,Bowling Green State,MAC,10,28,331,11.8,2,2,6,3.0,0,30,337,11.2,2,rb-marlow-iii-1
282,Stephan Robinson,Kansas,Big 12,12,28,330,11.8,1,0,0,,0,28,330,11.8,1,stephan-robinson-2
283,Chris Finke*,Notre Dame,Ind,13,49,571,11.7,2,5,20,4.0,0,54,591,10.9,2,chris-finke-1
284,Tony Pollard*,Memphis,American,14,39,458,11.7,3,78,552,7.1,6,117,1010,8.6,9,tony-pollard-1
285,Samson Nacua*,Utah,Pac-12,14,31,362,11.7,5,0,0,,0,31,362,11.7,5,samson-nacua-1
286,CJ Verdell*,Oregon,Pac-12,13,27,315,11.7,2,202,1018,5.0,10,229,1333,5.8,12,cj-verdell-1
287,Tyler Vaughns,USC,Pac-12,12,58,674,11.6,6,0,0,,0,58,674,11.6,6,tyler-vaughns-1
288,Trevon Bradford,Oregon State,Pac-12,11,56,649,11.6,6,12,136,11.3,0,68,785,11.5,6,trevon-bradford-1
289,Emeka Emezie*,North Carolina State,ACC,13,53,616,11.6,5,0,0,,0,53,616,11.6,5,emeka-emezie-1
290,Gatlin Casey*,Middle Tennessee State,CUSA,12,40,463,11.6,3,0,0,,0,40,463,11.6,3,gatlin-casey-1
291,Juwann Winfree,Colorado,Pac-12,8,28,324,11.6,2,0,0,,0,28,324,11.6,2,juwann-winfree-1
292,Flynn Nagel*,Northwestern,Big Ten,14,68,780,11.5,2,2,2,1.0,0,70,782,11.2,2,flynn-nagel-1
293,Jauan Wesley*,Northern Illinois,MAC,14,54,619,11.5,2,1,2,2.0,0,55,621,11.3,2,jauan-wesley-1
294,Marcus Armstrong-Brown*,Hawaii,MWC,14,50,573,11.5,2,0,0,,0,50,573,11.5,2,marcus-armstrong-brown-1
295,Dazz Newsome,North Carolina,ACC,11,44,506,11.5,2,7,96,13.7,1,51,602,11.8,3,dazz-newsome-1
296,Olamide Zaccheaus*,Virginia,ACC,13,93,1058,11.4,9,16,83,5.2,0,109,1141,10.5,9,olamide-zaccheaus-1
297,Jakobi Meyers*,North Carolina State,ACC,12,92,1047,11.4,4,3,-9,-3.0,0,95,1038,10.9,4,jakobi-meyers-1
298,Trenton Irwin*,Stanford,Pac-12,12,60,685,11.4,2,0,0,,0,60,685,11.4,2,trenton-irwin-1
299,Timmy Hernandez,Oregon State,Pac-12,12,58,661,11.4,3,1,3,3.0,0,59,664,11.3,3,timmy-hernandez-1
300,Jaylon Redd*,Oregon,Pac-12,13,38,433,11.4,5,3,22,7.3,1,41,455,11.1,6,jaylon-redd-1
301,Sam Mays,Illinois,Big Ten,12,29,331,11.4,0,0,0,,0,29,331,11.4,0,sam-mays-1
302,Travell Harris*,Washington State,Pac-12,13,27,309,11.4,1,1,3,3.0,0,28,312,11.1,1,travell-harris-1
303,Greg Campbell Jr.,UTSA,CUSA,11,58,658,11.3,2,6,23,3.8,0,64,681,10.6,2,greg-campbell-3
304,Keenen Brown,Texas State,Sun Belt,12,51,577,11.3,5,8,75,9.4,2,59,652,11.1,7,keenen-brown-2
305,Jason Huntley,New Mexico State,Ind,12,47,529,11.3,3,109,505,4.6,7,156,1034,6.6,10,jason-huntley-1
306,Mathew Sexton*,Eastern Michigan,MAC,12,37,419,11.3,3,0,0,,0,37,419,11.3,3,mathew-sexton-1
307,Maurice Ways*,California,Pac-12,13,34,383,11.3,1,0,0,,0,34,383,11.3,1,maurice-ways-1
308,Thayer Thomas*,North Carolina State,ACC,13,34,383,11.3,3,1,8,8.0,0,35,391,11.2,3,thayer-thomas-1
309,Blake Proehl,East Carolina,American,10,29,329,11.3,1,1,16,16.0,0,30,345,11.5,1,blake-proehl-1
310,Thomas Hennigan*,Appalachian State,Sun Belt,13,29,327,11.3,1,0,0,,0,29,327,11.3,1,thomas-hennigan-1
311,C.J. Riley*,North Carolina State,ACC,13,28,315,11.3,2,3,-11,-3.7,0,31,304,9.8,2,cj-riley-1
312,Markis McCray,Louisiana-Monroe,Sun Belt,12,27,304,11.3,0,13,50,3.8,0,40,354,8.9,0,markis-mccray-1
313,Matt Eaton*,Iowa State,Big 12,13,27,304,11.3,2,0,0,,0,27,304,11.3,2,matt-eaton-1
314,Giovanni Ricci*,Western Michigan,MAC,12,35,392,11.2,3,0,0,,0,35,392,11.2,3,giovanni-ricci-1
315,Isaiah Wright*,Temple,American,13,33,368,11.2,3,19,84,4.4,1,52,452,8.7,4,isaiah-wright-1
316,Julian Hicks,Central Michigan,MAC,10,28,313,11.2,4,1,12,12.0,0,29,325,11.2,4,julian-hicks-1
317,Ryeshene Bronson*,South Florida,American,10,25,281,11.2,1,1,3,3.0,0,26,284,10.9,1,ryeshene-bronson-1
318,Lynn Bowden Jr.*,Kentucky,SEC,13,67,745,11.1,5,9,25,2.8,0,76,770,10.1,5,lynn-bowden-jr-1
319,Hasise Dubois*,Virginia,ACC,13,52,578,11.1,5,0,0,,0,52,578,11.1,5,hasise-dubois-1
320,Hunter Renfrow*,Clemson,ACC,15,49,544,11.1,1,0,0,,0,49,544,11.1,1,hunter-renfrow-1
321,Elijah Moore,Ole Miss,SEC,12,36,398,11.1,2,3,8,2.7,0,39,406,10.4,2,elijah-moore-1
322,Jeremiah Booker,Kansas,Big 12,11,31,344,11.1,5,0,0,,0,31,344,11.1,5,jeremiah-booker-1
323,Raghib Ismail Jr.,Wyoming,MWC,11,24,267,11.1,2,4,-2,-0.5,0,28,265,9.5,2,raghib-ismail-jr-1
324,Velus Jones Jr.,USC,Pac-12,12,24,266,11.1,1,6,13,2.2,1,30,279,9.3,2,velus-jones-jr-1
325,Rondale Moore*,Purdue,Big Ten,13,114,1258,11.0,12,21,213,10.1,2,135,1471,10.9,14,rondale-moore-1
326,Lucky Jackson,Western Kentucky,CUSA,12,51,563,11.0,4,3,30,10.0,1,54,593,11.0,5,lucky-jackson-1
327,Landon Wolf*,Oklahoma State,Big 12,13,33,362,11.0,2,1,6,6.0,0,34,368,10.8,2,landon-wolf-1
328,Calvin Jackson Jr.*,Washington State,Pac-12,12,26,287,11.0,2,0,0,,0,26,287,11.0,2,calvin-jackson-jr-1
329,Terrell Green,East Carolina,American,12,26,285,11.0,0,1,2,2.0,0,27,287,10.6,0,terrell-green-1
330,Tommy Sweeney,Boston College,ACC,12,32,348,10.9,3,0,0,,0,32,348,10.9,3,tommy-sweeney-1
331,Alfred Smith*,Louisiana Tech,CUSA,13,30,327,10.9,2,1,16,16.0,0,31,343,11.1,2,alfred-smith-1
332,Sterling Palmer*,Florida International,CUSA,13,25,272,10.9,2,0,0,,0,25,272,10.9,2,sterling-palmer-1
333,T.J. Rahming*,Duke,ACC,13,75,811,10.8,8,9,82,9.1,0,84,893,10.6,8,tj-rahming-1
334,Albert Okwuegbunam*,Missouri,SEC,9,43,466,10.8,6,0,0,,0,43,466,10.8,6,albert-okwuegbunam-1
335,Workpeh Kofa,Charlotte,CUSA,12,34,368,10.8,0,1,0,0.0,0,35,368,10.5,0,workpeh-kofa-1
336,Cameron Butler,Colorado State,MWC,12,29,312,10.8,0,0,0,,0,29,312,10.8,0,cameron-butler-1
337,Ron'Quavion Tarver*,Utah State,MWC,13,66,709,10.7,8,1,4,4.0,0,67,713,10.6,8,ronquavion-tarver-1
338,Corey Lacanaria,Ball State,MAC,12,49,524,10.7,3,0,0,,0,49,524,10.7,3,corey-lacanaria-1
339,Quin Jernighan,Western Kentucky,CUSA,11,40,426,10.7,1,0,0,,0,40,426,10.7,1,quin-jernighan-1
340,Britain Covey*,Utah,Pac-12,13,60,637,10.6,1,21,172,8.2,0,81,809,10.0,1,britain-covey-1
341,Andre Baccellia*,Washington,Pac-12,14,55,584,10.6,0,2,50,25.0,0,57,634,11.1,0,andre-baccellia-1
342,Spencer Tears*,Northern Illinois,MAC,12,40,422,10.6,4,4,6,1.5,1,44,428,9.7,5,spencer-tears-1
343,C.J. Conrad*,Kentucky,SEC,13,30,318,10.6,3,0,0,,0,30,318,10.6,3,cj-conrad-1
344,Jordan Nathan*,Utah State,MWC,12,28,297,10.6,3,1,-2,-2.0,0,29,295,10.2,3,jordan-nathan-1
345,Kalija Lipscomb*,Vanderbilt,SEC,13,87,916,10.5,9,14,75,5.4,1,101,991,9.8,10,kalija-lipscomb-1
346,Kaleb Fossum*,Nevada,MWC,13,70,734,10.5,1,2,13,6.5,0,72,747,10.4,1,kaleb-fossum-1
347,Tyree McCants*,South Florida,American,13,59,617,10.5,3,8,52,6.5,0,67,669,10.0,3,tyree-mccants-1
348,Amari Rodgers*,Clemson,ACC,15,55,575,10.5,4,1,5,5.0,0,56,580,10.4,4,amari-rodgers-1
349,Danny Davis*,Wisconsin,Big Ten,11,40,418,10.5,5,4,56,14.0,0,44,474,10.8,5,danny-davis-5
350,Jaylond Adams,Southern Mississippi,CUSA,5,25,262,10.5,2,1,5,5.0,0,26,267,10.3,2,jaylond-adams-1
351,Kyle Sweet*,Washington State,Pac-12,13,33,342,10.4,0,0,0,,0,33,342,10.4,0,kyle-sweet-1
352,Tony Brown,Colorado,Pac-12,12,32,333,10.4,1,0,0,,0,32,333,10.4,1,tony-brown-9
353,Royce Caldwell,New Mexico State,Ind,12,29,303,10.4,2,20,112,5.6,0,49,415,8.5,2,royce-caldwell-1
354,Daniel Helm*,Duke,ACC,13,26,271,10.4,2,0,0,,0,26,271,10.4,2,daniel-helm-1
355,Kadarius Toney*,Florida,SEC,12,25,260,10.4,1,21,240,11.4,0,46,500,10.9,1,kadarius-toney-1
356,Rafael Araujo-Lopes*,Pitt,ACC,14,37,380,10.3,4,5,28,5.6,0,42,408,9.7,4,rafael-araujo-lopes-1
357,Kerr Johnson Jr.,Kansas,Big 12,10,30,309,10.3,2,1,1,1.0,0,31,310,10.0,2,kerr-johnson-jr-1
358,Jarion Anderson,Tulsa,American,12,28,288,10.3,1,0,0,,0,28,288,10.3,1,jarion-anderson-1
359,Trayveon Williams*,Texas A&M,SEC,13,27,278,10.3,1,271,1760,6.5,18,298,2038,6.8,19,trayveon-williams-1
360,Teddy Veal*,Louisiana Tech,CUSA,12,70,716,10.2,1,0,0,,0,70,716,10.2,1,teddy-veal-1
361,Shun Brown,Arizona,Pac-12,12,64,655,10.2,6,2,40,20.0,0,66,695,10.5,6,shun-brown-1
362,Austin Trammell,Rice,CUSA,13,62,632,10.2,3,1,3,3.0,0,63,635,10.1,3,austin-trammell-1
363,Antwan Dixon,Kent State,MAC,12,52,532,10.2,2,5,8,1.6,0,57,540,9.5,2,antwan-dixon-2
364,Kyle Williams*,Arizona State,Pac-12,13,44,449,10.2,2,1,8,8.0,0,45,457,10.2,2,kyle-williams-8
365,Whop Philyor,Indiana,Big Ten,7,23,235,10.2,1,5,68,13.6,0,28,303,10.8,1,whop-philyor-1
366,Steven Sims Jr.,Kansas,Big 12,12,53,535,10.1,4,2,29,14.5,0,55,564,10.3,4,steven-sims-jr-1
367,Isaiah McKoy,Kent State,MAC,11,42,423,10.1,3,0,0,,0,42,423,10.1,3,isaiah-mckoy-1
368,Vic Wharton*,California,Pac-12,12,50,502,10.0,1,2,15,7.5,0,52,517,9.9,1,vic-wharton-1
369,Alize Mack*,Notre Dame,Ind,12,36,360,10.0,3,0,0,,0,36,360,10.0,3,alize-mack-1
370,Andrew Beck*,Texas,Big 12,14,28,281,10.0,2,0,0,,0,28,281,10.0,2,andrew-beck-1
371,Tay Martin*,Washington State,Pac-12,13,69,685,9.9,8,0,0,,0,69,685,9.9,8,tay-martin-1
372,Patrick Smith*,Middle Tennessee State,CUSA,14,57,565,9.9,6,0,0,,0,57,565,9.9,6,patrick-smith-1
373,Seth Collins,Texas Tech,Big 12,12,32,317,9.9,2,2,6,3.0,0,34,323,9.5,2,seth-collins-1
374,OJ Clark,New Mexico State,Ind,12,52,512,9.8,1,0,0,,0,52,512,9.8,1,oj-clark-1
375,Deondre Douglas*,Troy,Sun Belt,11,48,472,9.8,7,4,81,20.3,0,52,553,10.6,7,deondre-douglas-1
376,Willie Wright,Florida Atlantic,CUSA,12,46,452,9.8,2,15,71,4.7,0,61,523,8.6,2,willie-wright-4
377,Jared Sparks*,Purdue,Big Ten,13,28,274,9.8,0,3,12,4.0,0,31,286,9.2,0,jared-sparks-1
378,Tre' McKitty,Florida State,ACC,12,26,256,9.8,2,0,0,,0,26,256,9.8,2,tre-mckitty-1
379,Dylan Drummond*,Eastern Michigan,MAC,13,25,245,9.8,1,0,0,,0,25,245,9.8,1,dylan-drummond-1
380,Deon Jackson*,Duke,ACC,13,26,253,9.7,2,161,847,5.3,7,187,1100,5.9,9,deon-jackson-1
381,Nick Easley*,Iowa,Big Ten,13,52,494,9.5,5,2,7,3.5,0,54,501,9.3,5,nick-easley-1
382,Jordan Mitchell,Southern Mississippi,CUSA,10,37,351,9.5,3,0,0,,0,37,351,9.5,3,jordan-mitchell-1
383,Taye Barber*,TCU,Big 12,13,32,303,9.5,2,4,-3,-0.8,0,36,300,8.3,2,taye-barber-1
384,Bryson Smith*,Houston,American,12,30,285,9.5,4,19,74,3.9,0,49,359,7.3,4,bryson-smith-1
385,Jordan McCray,South Alabama,Sun Belt,12,29,273,9.4,4,0,0,,0,29,273,9.4,4,jordan-mccray-2
386,Drake Harris*,Western Michigan,MAC,12,27,255,9.4,1,0,0,,0,27,255,9.4,1,drake-harris-1
387,Trey Harrell,Kent State,MAC,11,23,217,9.4,0,4,24,6.0,0,27,241,8.9,0,trey-harrell-1
388,Sidney Davis*,Troy,Sun Belt,13,43,399,9.3,3,5,30,6.0,1,48,429,8.9,4,sidney-davis-1
389,D'Andre Swift*,Georgia,SEC,14,32,297,9.3,3,163,1049,6.4,10,195,1346,6.9,13,dandre-swift-1
390,Trenard Davis,Illinois,Big Ten,12,30,278,9.3,0,2,-6,-3.0,0,32,272,8.5,0,trenard-davis-1
391,Kelvin Smith*,North Texas,CUSA,13,29,269,9.3,1,0,0,,0,29,269,9.3,1,kelvin-smith-3
392,Michael Warren II*,Cincinnati,American,12,25,232,9.3,1,244,1329,5.4,19,269,1561,5.8,20,michael-warren-ii-1
393,Luke Timian,Indiana,Big Ten,9,46,422,9.2,0,1,4,4.0,0,47,426,9.1,0,luke-timian-1
394,John Williams*,Memphis,American,14,33,304,9.2,2,4,40,10.0,0,37,344,9.3,2,john-williams-16
395,KeSean Carter,Texas Tech,Big 12,11,26,238,9.2,1,3,28,9.3,0,29,266,9.2,1,kesean-carter-1
396,Maurice Washington,Nebraska,Big Ten,11,24,221,9.2,1,77,455,5.9,3,101,676,6.7,4,maurice-washington-2
397,Thai Cottrell,San Jose State,MWC,11,24,220,9.2,1,14,10,0.7,0,38,230,6.1,1,thai-cottrell-1
398,Kenny Young,Miami (OH),MAC,10,42,384,9.1,4,59,367,6.2,4,101,751,7.4,8,kenny-young-2
399,D.J. Matthews,Florida State,ACC,12,42,382,9.1,1,2,0,0.0,0,44,382,8.7,1,dj-matthews-1
400,Braeden West,SMU,American,12,39,356,9.1,1,138,589,4.3,6,177,945,5.3,7,braeden-west-1
401,Anthony Muse,New Mexico State,Ind,12,23,210,9.1,1,1,3,3.0,0,24,213,8.9,1,anthony-muse-1
402,Justin Hall,Ball State,MAC,12,69,622,9.0,0,20,133,6.7,1,89,755,8.5,1,justin-hall-3
403,Hergy Mayala,Connecticut,American,12,40,361,9.0,5,0,0,,0,40,361,9.0,5,hergy-mayala-1
404,Brevin Jordan*,Miami (FL),ACC,12,32,287,9.0,4,0,0,,0,32,287,9.0,4,brevin-jordan-1
405,De'Michael Harris,Southern Mississippi,CUSA,11,27,241,8.9,2,9,80,8.9,0,36,321,8.9,2,demichael-harris-1
406,J-Shun Harris II,Indiana,Big Ten,12,37,325,8.8,2,2,1,0.5,0,39,326,8.4,2,j-shun-harris-ii-1
407,Hutch White,Texas State,Sun Belt,12,34,298,8.8,2,1,4,4.0,0,35,302,8.6,2,hutch-white-1
408,Pooka Williams,Kansas,Big 12,11,33,289,8.8,2,161,1125,7.0,7,194,1414,7.3,9,pooka-williams-1
409,Bo Melton,Rutgers,Big Ten,12,28,245,8.8,0,6,23,3.8,0,34,268,7.9,0,bo-melton-1
410,Devine Ozigbo,Nebraska,Big Ten,12,23,203,8.8,0,155,1082,7.0,12,178,1285,7.2,12,devine-ozigbo-1
411,Isaiah Harper,Old Dominion,CUSA,12,55,479,8.7,1,4,22,5.5,0,59,501,8.5,1,isaiah-harper-1
412,Tra Minter,South Alabama,Sun Belt,12,23,201,8.7,0,183,801,4.4,6,206,1002,4.9,6,tra-minter-1
413,Darrell Stewart Jr.*,Michigan State,Big Ten,11,48,413,8.6,1,4,22,5.5,0,52,435,8.4,1,darrell-stewart-jr-1
414,Devon Spalding,Central Michigan,MAC,10,27,231,8.6,0,9,38,4.2,0,36,269,7.5,0,devon-spalding-1
415,Cameron Green*,Northwestern,Big Ten,14,57,483,8.5,4,1,-4,-4.0,0,58,479,8.3,4,cameron-green-1
416,Deshaunte Jones*,Iowa State,Big 12,13,43,366,8.5,4,0,0,,0,43,366,8.5,4,deshaunte-jones-1
417,Tyler Mabry*,Buffalo,MAC,14,27,230,8.5,2,0,0,,0,27,230,8.5,2,tyler-mabry-2
418,Kyle Fourtenbary,Western Kentucky,CUSA,12,36,302,8.4,2,0,0,,0,36,302,8.4,2,kyle-fourtenbary-1
419,Raheem Blackshear,Rutgers,Big Ten,12,44,367,8.3,2,143,586,4.1,3,187,953,5.1,5,raheem-blackshear-1
420,Warren Wand*,Arkansas State,Sun Belt,13,26,213,8.2,1,139,792,5.7,4,165,1005,6.1,5,warren-wand-1
421,Deandre Torrey*,North Texas,CUSA,13,25,205,8.2,2,175,977,5.6,15,200,1182,5.9,17,deandre-torrey-1
422,Akilian Butler,Boise State,MWC,13,25,204,8.2,2,0,0,,0,25,204,8.2,2,akilian-butler-1
423,Desmond Phillips*,Toledo,MAC,13,27,220,8.1,0,0,0,,0,27,220,8.1,0,desmond-phillips-1
424,Ryan Davis*,Auburn,SEC,13,69,546,7.9,1,3,12,4.0,0,72,558,7.8,1,ryan-davis-5
425,Austin Conway,Wyoming,MWC,12,32,250,7.8,1,12,80,6.7,1,44,330,7.5,2,austin-conway-1
426,Connor Heyward*,Michigan State,Big Ten,13,32,249,7.8,0,118,529,4.5,5,150,778,5.2,5,connor-heyward-1
427,Eno Benjamin*,Arizona State,Pac-12,13,35,263,7.5,2,300,1642,5.5,16,335,1905,5.7,18,eno-benjamin-1
428,Da'Leon Ward,Texas Tech,Big 12,10,26,196,7.5,1,79,341,4.3,3,105,537,5.1,4,daleon-ward-1
429,James Williams*,Washington State,Pac-12,13,83,613,7.4,4,122,560,4.6,12,205,1173,5.7,16,james-williams-13
430,Tavares Thomas*,Middle Tennessee State,CUSA,12,38,283,7.4,4,81,246,3.0,5,119,529,4.4,9,tavares-thomas-1
431,Eddie Lewis,Rutgers,Big Ten,12,24,173,7.2,0,0,0,,0,24,173,7.2,0,eddie-lewis-2
432,Rakeem Boyd,Arkansas,SEC,12,23,165,7.2,0,123,734,6.0,2,146,899,6.2,2,rakeem-boyd-2
433,Max Borghi*,Washington State,Pac-12,13,53,374,7.1,4,72,366,5.1,8,125,740,5.9,12,max-borghi-1
434,Joshua Kelley,UCLA,Pac-12,11,27,193,7.1,0,225,1243,5.5,12,252,1436,5.7,12,joshua-kelley-1
435,Zavier Scott,Connecticut,American,10,33,228,6.9,1,34,210,6.2,0,67,438,6.5,1,zavier-scott-1
436,D.J. Knox*,Purdue,Big Ten,13,27,180,6.7,1,157,883,5.6,8,184,1063,5.8,9,dj-knox-1
437,JaMycal Hasty*,Baylor,Big 12,11,26,170,6.5,1,82,434,5.3,4,108,604,5.6,5,jamycal-hasty-1
438,Alexander Mattison,Boise State,MWC,13,27,173,6.4,0,302,1415,4.7,17,329,1588,4.8,17,alexander-mattison-1
439,Keaontay Ingram*,Texas,Big 12,13,27,170,6.3,2,142,708,5.0,3,169,878,5.2,5,keaontay-ingram-1
440,Izzy Matthews,Colorado State,MWC,12,27,169,6.3,1,166,717,4.3,4,193,886,4.6,5,izzy-matthews-1
441,Cam Akers,Florida State,ACC,12,23,145,6.3,2,161,706,4.4,6,184,851,4.6,8,cam-akers-1
442,LeVante Bellamy*,Western Michigan,MAC,13,30,185,6.2,1,205,1228,6.0,6,235,1413,6.0,7,levante-bellamy-1
443,Reese Taylor,Indiana,Big Ten,12,28,174,6.2,0,15,83,5.5,0,43,257,6.0,0,reese-taylor-1
444,Jermar Jefferson,Oregon State,Pac-12,12,25,147,5.9,0,239,1380,5.8,12,264,1527,5.8,12,jermar-jefferson-1
445,Jeremy Cox,Old Dominion,CUSA,9,24,139,5.8,0,103,453,4.4,5,127,592,4.7,5,jeremy-cox-1
446,Patrick Laird*,California,Pac-12,13,51,288,5.6,4,223,961,4.3,5,274,1249,4.6,9,patrick-laird-2
447,Michael Carter,North Carolina,ACC,9,25,135,5.4,1,84,597,7.1,2,109,732,6.7,3,michael-carter-5
448,Trivenskey Mosley,Southern Mississippi,CUSA,10,25,92,3.7,0,99,494,5.0,1,124,586,4.7,1,trivenskey-mosley-1