Rk,Player,School,Conf,G,Att,Yds,Avg,TD,Rec,Yds,Avg,TD,Plays,Yds,Avg,TD,-9999
1,Kendre Miller,TCU,Big 12,10,83,623,7.5,7,12,117,9.8,1,95,740,7.8,8,kendre-miller-1
2,Anthony Watkins*,Tulsa,American,13,86,634,7.4,4,4,28,7.0,0,90,662,7.4,4,anthony-watkins-3
3,Devon Achane,Texas A&M,SEC,12,130,910,7.0,9,24,261,10.9,1,154,1171,7.6,10,devon-achane-1
4,Johnny Richardson*,UCF,American,13,104,733,7.0,3,25,226,9.0,1,129,959,7.4,4,johnny-richardson-4
5,Zach Evans,TCU,Big 12,6,92,648,7.0,5,10,130,13.0,1,102,778,7.6,6,zach-evans-1
6,Braelon Allen*,Wisconsin,Big Ten,12,186,1268,6.8,12,8,39,4.9,0,194,1307,6.7,12,braelon-allen-1
7,TreVeyon Henderson*,Ohio State,Big Ten,13,183,1248,6.8,15,27,312,11.6,4,210,1560,7.4,19,treveyon-henderson-1
8,Bryant Koback*,Toledo,MAC,13,208,1400,6.7,15,30,334,11.1,3,238,1734,7.3,18,bryant-koback-1
9,DeWayne McBride*,UAB,CUSA,13,204,1371,6.7,13,3,19,6.3,0,207,1390,6.7,13,dewayne-mcbride-1
10,Blake Corum*,Michigan,Big Ten,12,143,952,6.7,11,24,141,5.9,1,167,1093,6.5,12,blake-corum-1
11,Tyjae Spears,Tulane,American,12,129,863,6.7,9,19,145,7.6,0,148,1008,6.8,9,tyjae-spears-1
12,Jamyest Williams*,Georgia State,Sun Belt,13,128,859,6.7,9,1,19,19.0,0,129,878,6.8,9,jamyest-williams-1
13,T.J. Pledger*,Utah,Pac-12,14,104,694,6.7,6,10,107,10.7,0,114,801,7.0,6,tj-pledger-1
14,Jarquez Hunter*,Auburn,SEC,13,89,593,6.7,3,12,61,5.1,1,101,654,6.5,4,jarquez-hunter-1
15,Zaquandre White*,South Carolina,SEC,12,88,583,6.6,2,19,202,10.6,3,107,785,7.3,5,zaquandre-white-1
16,Keaton Mitchell,East Carolina,American,12,174,1132,6.5,9,22,253,11.5,1,196,1385,7.1,10,keaton-mitchell-1
17,Shermari Jones*,Coastal Carolina,Sun Belt,11,159,1040,6.5,13,3,28,9.3,0,162,1068,6.6,13,shermari-jones-1
18,Xavier Williams*,Kent State,MAC,13,125,812,6.5,3,4,40,10.0,0,129,852,6.6,3,xavier-williams-2
19,Tahj Brooks*,Texas Tech,Big 12,9,87,568,6.5,7,6,52,8.7,0,93,620,6.7,7,tahj-brooks-1
20,Sean Tyler*,Western Michigan,MAC,13,178,1140,6.4,9,14,114,8.1,2,192,1254,6.5,11,sean-tyler-1
21,James Cook*,Georgia,SEC,15,113,728,6.4,7,27,284,10.5,4,140,1012,7.2,11,james-cook-2
22,Dae Dae Hunter,Hawaii,MWC,10,101,651,6.4,3,19,163,8.6,0,120,814,6.8,3,dae-dae-hunter-1
23,Ulysses Bentley IV,SMU,American,11,96,610,6.4,4,19,90,4.7,1,115,700,6.1,5,ulysses-bentley-iv-1
24,Treshaun Ward,Florida State,ACC,12,81,515,6.4,4,21,185,8.8,1,102,700,6.9,5,treshaun-ward-1
25,Abram Smith*,Baylor,Big 12,14,257,1621,6.3,12,13,75,5.8,0,270,1696,6.3,12,abram-smith-1
26,Kennedy Brooks*,Oklahoma,Big 12,13,198,1253,6.3,13,9,73,8.1,0,207,1326,6.4,13,kennedy-brooks-1
27,Johnny Ford,Florida Atlantic,CUSA,11,131,831,6.3,5,23,282,12.3,2,154,1113,7.2,7,johnny-ford-1
28,Emani Bailey*,Louisiana,Sun Belt,11,102,642,6.3,8,15,153,10.2,0,117,795,6.8,8,emani-bailey-1
29,Kenneth Walker III*,Michigan State,Big Ten,12,263,1636,6.2,18,13,89,6.8,1,276,1725,6.3,19,kenneth-walker-iii-1
30,Jerome Ford*,Cincinnati,American,13,214,1319,6.2,19,21,220,10.5,1,235,1539,6.5,20,jerome-ford-1
31,Jashaun Corbin,Florida State,ACC,12,143,887,6.2,7,25,144,5.8,1,168,1031,6.1,8,jashaun-corbin-1
32,Kobe Pace*,Clemson,ACC,11,104,641,6.2,6,12,131,10.9,0,116,772,6.7,6,kobe-pace-1
33,Jawon Hamilton*,Eastern Michigan,MAC,11,101,623,6.2,4,1,7,7.0,0,102,630,6.2,4,jawon-hamilton-1
34,Kelley Joiner Jr.,South Florida,American,12,78,480,6.2,2,8,62,7.8,0,86,542,6.3,2,kelley-joiner-jr-1
35,Sean Tucker,Syracuse,ACC,12,246,1496,6.1,12,20,255,12.8,2,266,1751,6.6,14,sean-tucker-2
36,Christopher Rodriguez Jr.*,Kentucky,SEC,13,225,1379,6.1,9,13,61,4.7,3,238,1440,6.1,12,christopher-rodriguez-jr-1
37,Noah Whittington*,Western Kentucky,CUSA,12,101,617,6.1,2,12,58,4.8,0,113,675,6.0,2,noah-whittington-1
38,Tyler Badie*,Missouri,SEC,12,268,1604,6.0,14,54,330,6.1,4,322,1934,6.0,18,tyler-badie-1
39,Deuce Vaughn*,Kansas State,Big 12,13,235,1404,6.0,18,49,468,9.6,4,284,1872,6.6,22,deuce-vaughn-1
40,Travis Dye*,Oregon,Pac-12,14,211,1271,6.0,16,46,402,8.7,2,257,1673,6.5,18,travis-dye-1
41,Ty Chandler*,North Carolina,ACC,13,182,1092,6.0,13,15,216,14.4,1,197,1308,6.6,14,ty-chandler-1
42,Malik Cunningham*,Louisville,ACC,13,173,1031,6.0,20,1,9,9.0,0,174,1040,6.0,20,malik-cunningham-1
43,Brittain Brown,UCLA,Pac-12,10,102,615,6.0,7,18,129,7.2,0,120,744,6.2,7,brittain-brown-1
44,Armani Rogers,Ohio,MAC,12,92,552,6.0,7,2,2,1.0,0,94,554,5.9,7,armani-rogers-1
45,B.J. Baylor*,Oregon State,Pac-12,13,227,1337,5.9,13,8,75,9.4,0,235,1412,6.0,13,bj-baylor-1
46,Chase Brown,Illinois,Big Ten,10,170,1005,5.9,5,14,142,10.1,0,184,1147,6.2,5,chase-brown-3
47,Titus Swen*,Wyoming,MWC,13,132,785,5.9,7,6,30,5.0,0,138,815,5.9,7,titus-swen-1
48,Dominique Johnson*,Arkansas,SEC,13,97,575,5.9,7,7,71,10.1,1,104,646,6.2,8,dominique-johnson-2
49,Roschon Johnson,Texas,Big 12,12,96,569,5.9,5,11,83,7.5,0,107,652,6.1,5,roschon-johnson-1
50,Ayo Adeyi*,North Texas,CUSA,10,84,496,5.9,6,1,3,3.0,0,85,499,5.9,6,ayo-adeyi-1
51,Tyler Allgeier*,Brigham Young,Ind,13,276,1606,5.8,23,28,199,7.1,0,304,1805,5.9,23,tyler-allgeier-1
52,Breece Hall*,Iowa State,Big 12,12,253,1464,5.8,20,36,302,8.4,3,289,1766,6.1,23,breece-hall-1
53,Bijan Robinson,Texas,Big 12,10,195,1127,5.8,11,26,295,11.3,4,221,1422,6.4,15,bijan-robinson-1
54,Keaontay Ingram,USC,Pac-12,10,156,911,5.8,5,22,156,7.1,0,178,1067,6.0,5,keaontay-ingram-1
55,De'Montre Tuggle,Ohio,MAC,12,138,804,5.8,7,16,156,9.8,2,154,960,6.2,9,demontre-tuggle-1
56,Jerrion Ealy*,Ole Miss,SEC,12,133,768,5.8,5,32,218,6.8,2,165,986,6.0,7,jerrion-ealy-1
57,Raheem Blackshear*,Virginia Tech,ACC,13,133,765,5.8,6,25,249,10.0,1,158,1014,6.4,7,raheem-blackshear-1
58,Brandon Thomas,Memphis,American,9,116,669,5.8,8,8,52,6.5,0,124,721,5.8,8,brandon-thomas-5
59,Nate Noel*,Appalachian State,Sun Belt,14,199,1126,5.7,4,8,16,2.0,0,207,1142,5.5,4,nate-noel-1
60,Dameon Pierce*,Florida,SEC,13,100,574,5.7,13,19,216,11.4,3,119,790,6.6,16,dameon-pierce-1
61,Harrison Waylee*,Northern Illinois,MAC,5,101,574,5.7,4,1,6,6.0,0,102,580,5.7,4,harrison-waylee-1
62,Rasheen Ali*,Marshall,CUSA,13,250,1401,5.6,23,46,342,7.4,1,296,1743,5.9,24,rasheen-ali-1
63,Zach Charbonnet,UCLA,Pac-12,12,203,1137,5.6,13,24,197,8.2,0,227,1334,5.9,13,zach-charbonnet-1
64,Isaiah Spiller,Texas A&M,SEC,12,179,1011,5.6,6,25,189,7.6,1,204,1200,5.9,7,isaiah-spiller-1
65,Camerun Peoples*,Appalachian State,Sun Belt,12,166,926,5.6,14,2,19,9.5,0,168,945,5.6,14,camerun-peoples-1
66,Chris Smith*,Louisiana,Sun Belt,13,153,855,5.6,8,14,75,5.4,1,167,930,5.6,9,chris-smith-22
67,Jabari Small*,Tennessee,SEC,11,141,796,5.6,9,9,77,8.6,0,150,873,5.8,9,jabari-small-1
68,Tayon Fleet-Davis*,Maryland,Big Ten,13,128,721,5.6,8,32,305,9.5,1,160,1026,6.4,9,tayon-fleet-davis-1
69,Calvin Hill,Texas State,Sun Belt,12,128,714,5.6,3,18,78,4.3,0,146,792,5.4,3,calvin-hill-4
70,Jordan Mims*,Fresno State,MWC,13,127,710,5.6,6,25,324,13.0,4,152,1034,6.8,10,jordan-mims-1
71,Christian Anderson*,Army,Ind,12,116,652,5.6,9,0,0,,0,116,652,5.6,9,christian-anderson-2
72,Calvin Camp,Charlotte,CUSA,12,113,635,5.6,4,15,130,8.7,1,128,765,6.0,5,calvin-camp-1
73,Jaxson Kincaide*,Western Michigan,MAC,13,84,473,5.6,5,3,11,3.7,0,87,484,5.6,5,jaxson-kincaide-1
74,Malik Jackson,Louisiana-Monroe,Sun Belt,11,80,451,5.6,3,10,40,4.0,0,90,491,5.5,3,malik-jackson-6
75,Gerald Green,Georgia Southern,Sun Belt,11,75,423,5.6,5,8,81,10.1,0,83,504,6.1,5,gerald-green-5
76,Rachaad White*,Arizona State,Pac-12,11,182,1006,5.5,15,43,456,10.6,1,225,1462,6.5,16,rachaad-white-1
77,Max Borghi*,Washington State,Pac-12,12,160,880,5.5,12,16,156,9.8,0,176,1036,5.9,12,max-borghi-1
78,Lew Nichols*,Central Michigan,MAC,13,341,1848,5.4,16,40,338,8.5,2,381,2186,5.7,18,lew-nichols-1
79,Jevyon Ducker*,Northern Illinois,MAC,12,218,1184,5.4,3,1,15,15.0,0,219,1199,5.5,3,jevyon-ducker-1
80,Tavion Thomas*,Utah,Pac-12,13,204,1108,5.4,21,2,3,1.5,0,206,1111,5.4,21,tavion-thomas-1
81,Zamir White*,Georgia,SEC,15,160,856,5.4,11,9,75,8.3,0,169,931,5.5,11,zamir-white-1
82,Trestan Ebner*,Baylor,Big 12,14,148,799,5.4,2,28,284,10.1,2,176,1083,6.2,4,trestan-ebner-1
83,Zonovan Knight,North Carolina State,ACC,12,140,753,5.4,3,21,156,7.4,0,161,909,5.6,3,zonovan-knight-1
84,Elijah Davis*,Old Dominion,CUSA,13,105,562,5.4,6,7,27,3.9,0,112,589,5.3,6,elijah-davis-3
85,Lala Davis*,Old Dominion,CUSA,13,105,562,5.4,6,7,27,3.9,0,112,589,5.3,6,lala-davis-1
86,Dillon Johnson*,Mississippi State,SEC,13,89,485,5.4,4,65,422,6.5,1,154,907,5.9,5,dillon-johnson-1
87,Ronald Awatt*,UTEP,CUSA,13,158,844,5.3,6,11,158,14.4,0,169,1002,5.9,6,ronald-awatt-1
88,Logan Wright,Georgia Southern,Sun Belt,12,150,793,5.3,8,17,180,10.6,0,167,973,5.8,8,logan-wright-2
89,Emory Jones*,Florida,SEC,13,143,758,5.3,4,2,28,14.0,1,145,786,5.4,5,emory-jones-1
90,Bucky Irving*,Minnesota,Big Ten,12,133,699,5.3,4,8,73,9.1,0,141,772,5.5,4,markeise-irving-1
91,D'Vonte Price,Florida International,CUSA,9,129,682,5.3,6,10,83,8.3,0,139,765,5.5,6,dvonte-price-1
92,Israel Abanikanda*,Pitt,ACC,13,123,651,5.3,7,24,197,8.2,1,147,848,5.8,8,israel-abanikanda-1
93,Dedrick Parson,Hawaii,MWC,13,117,618,5.3,8,28,279,10.0,1,145,897,6.2,9,dedrick-parson-1
94,Henry Parrish Jr.*,Ole Miss,SEC,13,105,553,5.3,3,21,173,8.2,0,126,726,5.8,3,henry-parrish-jr-1
95,Ikaika Ragsdale*,North Texas,CUSA,12,100,534,5.3,5,4,23,5.8,0,104,557,5.4,5,ikaika-ragsdale-1
96,Malik Davis*,Florida,SEC,12,92,487,5.3,5,23,217,9.4,2,115,704,6.1,7,malik-davis-1
97,Ellis Merriweather,Massachusetts,Ind,12,218,1138,5.2,5,22,165,7.5,1,240,1303,5.4,6,ellis-merriweather-1
98,Blake Watson*,Old Dominion,CUSA,11,215,1112,5.2,8,10,55,5.5,1,225,1167,5.2,9,blake-watson-2
99,Montrell Johnson*,Louisiana,Sun Belt,14,162,838,5.2,12,6,53,8.8,0,168,891,5.3,12,montrell-johnson-1
100,Jahmyr Gibbs,Georgia Tech,ACC,12,143,746,5.2,4,36,470,13.1,2,179,1216,6.8,6,jahmyr-gibbs-1
101,Christopher Brooks,California,Pac-12,12,116,607,5.2,4,19,131,6.9,3,135,738,5.5,7,christopher-brooks-1
102,Frank Harris*,UTSA,CUSA,14,109,566,5.2,6,3,36,12.0,1,112,602,5.4,7,frank-harris-3
103,Deneric Prince*,Tulsa,American,10,100,524,5.2,5,7,67,9.6,0,107,591,5.5,5,deneric-prince-1
104,Damien Moore,California,Pac-12,11,100,518,5.2,6,13,85,6.5,1,113,603,5.3,7,damien-moore-1
105,Xazavian Valladay*,Wyoming,MWC,13,209,1070,5.1,6,23,233,10.1,0,232,1303,5.6,6,xazavian-valladay-1
106,Dylan McDuffie,Buffalo,MAC,12,206,1049,5.1,11,14,113,8.1,1,220,1162,5.3,12,dylan-mcduffie-1
107,Patrick Garwo,Boston College,ACC,12,205,1045,5.1,7,3,19,6.3,0,208,1064,5.1,7,patrick-garwo-1
108,Evan Hull,Northwestern,Big Ten,12,196,1009,5.1,7,33,264,8.0,2,229,1273,5.6,9,evan-hull-2
109,Alton McCaskill*,Houston,American,14,189,961,5.1,16,21,113,5.4,2,210,1074,5.1,18,alton-mccaskill-1
110,Jayden Daniels*,Arizona State,Pac-12,13,138,710,5.1,6,0,0,,0,138,710,5.1,6,jayden-daniels-1
111,Juwuan Price,New Mexico State,Ind,12,135,692,5.1,10,26,181,7.0,0,161,873,5.4,10,juwuan-price-1
112,Jermaine Brown Jr.*,UAB,CUSA,13,123,631,5.1,7,23,200,8.7,0,146,831,5.7,7,jermaine-brown-jr-1
113,Raheim Sanders*,Arkansas,SEC,13,114,578,5.1,5,11,109,9.9,1,125,687,5.5,6,raheim-sanders-1
114,Justice Ellison*,Wake Forest,ACC,11,107,541,5.1,7,7,37,5.3,1,114,578,5.1,8,justice-ellison-1
115,Nathaniel Peat,Stanford,Pac-12,12,79,404,5.1,3,11,63,5.7,0,90,467,5.2,3,nathaniel-peat-1
116,Sincere McCormick*,UTSA,CUSA,14,298,1479,5.0,15,22,184,8.4,0,320,1663,5.2,15,sincere-mccormick-1
117,Brian Robinson Jr.*,Alabama,SEC,14,271,1343,5.0,14,35,296,8.5,2,306,1639,5.4,16,brian-robinson-jr-1
118,Charles Williams,UNLV,MWC,12,254,1261,5.0,15,13,202,15.5,0,267,1463,5.5,15,charles-williams-8
119,Marquez Cooper*,Kent State,MAC,14,241,1205,5.0,11,10,95,9.5,0,251,1300,5.2,11,marquez-cooper-1
120,Tucker Gregg*,Georgia State,Sun Belt,13,192,953,5.0,9,2,12,6.0,0,194,965,5.0,9,tucker-gregg-1
121,Ky Thomas*,Minnesota,Big Ten,9,166,824,5.0,6,6,44,7.3,0,172,868,5.0,6,ky-thomas-1
122,Will Shipley*,Clemson,ACC,10,149,738,5.0,11,16,116,7.3,0,165,854,5.2,11,will-shipley-1
123,Darren Grainger*,Georgia State,Sun Belt,13,133,660,5.0,3,0,0,,0,133,660,5.0,3,darren-grainger-1
124,Snoop Conner*,Ole Miss,SEC,13,130,647,5.0,13,14,82,5.9,0,144,729,5.1,13,snoop-conner-1
125,Trelon Smith*,Arkansas,SEC,13,119,598,5.0,5,4,21,5.3,0,123,619,5.0,5,trelon-smith-1
126,Rocky Lombardi*,Northern Illinois,MAC,13,94,472,5.0,9,0,0,,0,94,472,5.0,9,rocky-lombardi-1
127,Jordan Mason,Georgia Tech,ACC,12,87,439,5.0,1,10,85,8.5,1,97,524,5.4,2,jordan-mason-1
128,Ron Cook Jr.,Buffalo,MAC,12,88,438,5.0,3,24,240,10.0,1,112,678,6.1,4,ron-cook-jr-1
129,Trevion Cooley*,Louisville,ACC,12,86,431,5.0,1,12,173,14.4,2,98,604,6.2,3,trevion-cooley-1
130,Hassan Haskins*,Michigan,Big Ten,14,270,1327,4.9,20,18,131,7.3,0,288,1458,5.1,20,hassan-haskins-1
131,Mataeo Durant,Duke,ACC,12,255,1241,4.9,9,27,256,9.5,2,282,1497,5.3,11,mataeo-durant-1
132,Deandre Torrey*,North Texas,CUSA,12,248,1215,4.9,13,12,115,9.6,1,260,1330,5.1,14,deandre-torrey-1
133,Tank Bigsby*,Auburn,SEC,13,224,1102,4.9,10,21,184,8.8,0,245,1286,5.2,10,tank-bigsby-1
134,Kyren Williams*,Notre Dame,Ind,12,204,1002,4.9,14,42,359,8.5,3,246,1361,5.5,17,kyren-williams-1
135,Ronnie Rivers*,Fresno State,MWC,11,161,788,4.9,5,34,364,10.7,2,195,1152,5.9,7,ronnie-rivers-1
136,Toa Taua*,Nevada,MWC,13,150,730,4.9,6,39,296,7.6,1,189,1026,5.4,7,toa-taua-1
137,Tre Siggers,SMU,American,11,147,727,4.9,9,9,56,6.2,1,156,783,5.0,10,tre-siggers-1
138,Jonzell Norrils,Akron,MAC,10,118,573,4.9,3,17,153,9.0,3,135,726,5.4,6,jonzell-norrils-1
139,Ari Broussard,Rice,CUSA,12,116,569,4.9,3,0,0,,0,116,569,4.9,3,ari-broussard-1
140,Treyson Potts*,Minnesota,Big Ten,5,112,552,4.9,6,2,14,7.0,0,114,566,5.0,6,treyson-potts-1
141,Josh McCray,Illinois,Big Ten,11,112,549,4.9,2,2,43,21.5,0,114,592,5.2,2,josh-mccray-1
142,Keyvone Lee*,Penn State,Big Ten,13,108,530,4.9,2,15,130,8.7,0,123,660,5.4,2,keyvone-lee-1
143,Rodney Hammond Jr.*,Pitt,ACC,12,102,504,4.9,5,8,57,7.1,2,110,561,5.1,7,rodney-hammond-jr-1
144,Rodrigues Clark,Memphis,American,10,79,387,4.9,4,11,59,5.4,1,90,446,5.0,5,rodrigues-clark-1
145,Jaylen Warren*,Oklahoma State,Big 12,14,256,1216,4.8,11,25,225,9.0,0,281,1441,5.1,11,jaylen-warren-1
146,Leddie Brown*,West Virginia,Big 12,12,223,1065,4.8,13,36,217,6.0,1,259,1282,4.9,14,leddie-brown-1
147,Tyrion Davis-Price*,LSU,SEC,12,211,1003,4.8,6,10,64,6.4,0,221,1067,4.8,6,tyrion-davis-price-1
148,Aaron Dumas,New Mexico,MWC,11,136,658,4.8,2,0,0,,0,136,658,4.8,2,aaron-dumas-1
149,George Holani,Boise State,MWC,9,119,569,4.8,1,14,169,12.1,0,133,738,5.5,1,george-holani-1
150,Deon McIntosh*,Washington State,Pac-12,11,111,532,4.8,3,14,108,7.7,1,125,640,5.1,4,deon-mcintosh-1
151,Dajon Richard,Southern Mississippi,CUSA,11,94,447,4.8,2,7,61,8.7,0,101,508,5.0,2,dajon-richard-2
152,Jaylen Wright*,Tennessee,SEC,9,85,409,4.8,4,6,22,3.7,0,91,431,4.7,4,jaylen-wright-1
153,Shamari Brooks*,Tulsa,American,13,218,1029,4.7,7,8,71,8.9,0,226,1100,4.9,7,shamari-brooks-1
154,Chez Mellusi*,Wisconsin,Big Ten,9,173,815,4.7,5,7,66,9.4,0,180,881,4.9,5,chez-mellusi-1
155,Haaziq Daniels*,Air Force,MWC,12,155,734,4.7,11,0,0,,0,155,734,4.7,11,haaziq-daniels-1
156,Jalen Mitchell*,Louisville,ACC,12,155,722,4.7,5,12,121,10.1,0,167,843,5.0,5,jalen-mitchell-1
157,Jarek Broussard,Colorado,Pac-12,11,142,661,4.7,2,13,81,6.2,0,155,742,4.8,2,jarek-broussard-1
158,Ricky Person Jr.,North Carolina State,ACC,12,135,636,4.7,5,28,240,8.6,2,163,876,5.4,7,ricky-person-jr-1
159,Dorian Thompson-Robinson,UCLA,Pac-12,11,130,609,4.7,9,0,0,,0,130,609,4.7,9,dorian-thompson-robinson-1
160,SaRodorick Thompson*,Texas Tech,Big 12,11,107,500,4.7,10,6,113,18.8,0,113,613,5.4,10,sarodorick-thompson-1
161,Malachi Thomas*,Virginia Tech,ACC,12,93,440,4.7,3,2,33,16.5,0,95,473,5.0,3,malachi-thomas-1
162,Carson Steele*,Ball State,MAC,13,192,891,4.6,6,12,157,13.1,1,204,1048,5.1,7,carson-steele-1
163,Tyler Nevens,San Jose State,MWC,11,167,766,4.6,7,8,42,5.3,1,175,808,4.6,8,tyler-nevens-1
164,Kimani Vidal,Troy,Sun Belt,11,152,701,4.6,5,22,134,6.1,0,174,835,4.8,5,kimani-vidal-1
165,Spencer Sanders*,Oklahoma State,Big 12,13,146,668,4.6,6,1,6,6.0,0,147,674,4.6,6,spencer-sanders-1
166,Christian Beal*,Wake Forest,ACC,12,131,604,4.6,7,9,55,6.1,0,140,659,4.7,7,christian-beal-1
167,Christian Beal-Smith*,Wake Forest,ACC,12,131,604,4.6,7,9,55,6.1,0,140,659,4.7,7,christian-beal-smith-1
168,Nate Carter,Connecticut,Ind,12,125,578,4.6,2,19,127,6.7,0,144,705,4.9,2,nate-carter-4
169,Keyon Mozee*,Miami (OH),MAC,13,122,556,4.6,4,2,20,10.0,0,124,576,4.6,4,keyon-mozee-1
170,Cameron Carroll,Tulane,American,12,111,516,4.6,3,17,198,11.6,3,128,714,5.6,6,cameron-carroll-1
171,Ta'Zhawn Henry*,Houston,American,13,111,513,4.6,7,21,110,5.2,0,132,623,4.7,7,tazhawn-henry-1
172,Emari Demercado,TCU,Big 12,11,96,446,4.6,4,12,94,7.8,0,108,540,5.0,4,emari-demercado-1
173,Brad Roberts*,Air Force,MWC,13,299,1356,4.5,13,0,0,,0,299,1356,4.5,13,brad-roberts-1
174,Tyler Goodson*,Iowa,Big Ten,13,256,1151,4.5,6,31,247,8.0,1,287,1398,4.9,7,tyler-goodson-1
175,Greg Bell*,San Diego State,MWC,14,245,1091,4.5,9,4,5,1.3,0,249,1096,4.4,9,greg-bell-5
176,Calvin Tyler Jr.*,Utah State,MWC,12,196,884,4.5,7,11,50,4.5,0,207,934,4.5,7,calvin-tyler-jr-1
177,Malik Willis*,Liberty,Ind,13,197,878,4.5,13,1,13,13.0,0,198,891,4.5,13,malik-willis-1
178,La'darius Jefferson*,Western Michigan,MAC,12,185,836,4.5,10,3,38,12.7,0,188,874,4.6,10,ladarius-jefferson-1
179,Sam Howell*,North Carolina,ACC,12,183,828,4.5,11,0,0,,0,183,828,4.5,11,sam-howell-1
180,Frank Gore Jr.,Southern Mississippi,CUSA,12,179,801,4.5,5,20,155,7.8,0,199,956,4.8,5,frank-gore-jr-1
181,Garrett Shrader,Syracuse,ACC,12,173,781,4.5,14,0,0,,0,173,781,4.5,14,garrett-shrader-1
182,Devin Neal,Kansas,Big 12,11,158,707,4.5,8,7,57,8.1,1,165,764,4.6,9,devin-neal-3
183,K.J. Jefferson*,Arkansas,SEC,13,146,664,4.5,6,0,0,,0,146,664,4.5,6,kj-jefferson-1
184,DeQuan Finn*,Toledo,MAC,13,111,505,4.5,9,0,10,,0,111,515,4.6,9,dequan-finn-1
185,Dustin Crum*,Kent State,MAC,14,161,703,4.4,12,0,0,,1,161,703,4.4,13,dustin-crum-1
186,Isaiah Bowser*,UCF,American,8,159,703,4.4,9,9,75,8.3,0,168,778,4.6,9,isaiah-bowser-1
187,Anthony Brown*,Oregon,Pac-12,14,151,658,4.4,9,0,0,,0,151,658,4.4,9,anthony-brown-11
188,Shadrick Byrd,Charlotte,CUSA,12,132,583,4.4,3,21,256,12.2,2,153,839,5.5,5,shadrick-byrd-1
189,Braxton Burmeister*,Virginia Tech,ACC,12,116,508,4.4,2,1,3,3.0,1,117,511,4.4,3,braxton-burmeister-1
190,Vavae Malepeai,USC,Pac-12,12,114,502,4.4,6,12,65,5.4,0,126,567,4.5,6,vavae-malepeai-1
191,Rahmir Johnson,Nebraska,Big Ten,10,112,495,4.4,4,16,197,12.3,2,128,692,5.4,6,rahmir-johnson-1
192,Clint Ratkovich*,Northern Illinois,MAC,14,105,461,4.4,13,15,124,8.3,2,120,585,4.9,15,clint-ratkovich-1
193,Chase Garbers,California,Pac-12,11,104,456,4.4,4,0,0,,0,104,456,4.4,4,chase-garbers-1
194,Drake Anderson,Arizona,Pac-12,11,87,384,4.4,1,18,95,5.3,0,105,479,4.6,1,drake-anderson-1
195,Patrick Smith,Vanderbilt,SEC,10,82,360,4.4,1,16,84,5.3,0,98,444,4.5,1,patrick-smith-3
196,Isaiah Johnson*,North Texas,CUSA,10,82,359,4.4,5,7,95,13.6,1,89,454,5.1,6,isaiah-johnson-10
197,Nick Mosley,Bowling Green State,MAC,12,77,336,4.4,2,1,4,4.0,0,78,340,4.4,2,nick-mosley-1
198,Kevin Harris*,South Carolina,SEC,12,152,659,4.3,4,11,89,8.1,0,163,748,4.6,4,kevin-harris-5
199,Elelyon Noa*,Utah State,MWC,14,138,597,4.3,4,11,85,7.7,0,149,682,4.6,4,elelyon-noa-1
200,Lincoln Pare,Arkansas State,Sun Belt,12,107,455,4.3,1,27,283,10.5,2,134,738,5.5,3,lincoln-pare-1
201,Jason Bean,Kansas,Big 12,11,92,400,4.3,2,1,-1,-1.0,0,93,399,4.3,2,jason-bean-1
202,Jaren Mangham,South Florida,American,12,160,671,4.2,15,5,50,10.0,0,165,721,4.4,15,jaren-mangham-1
203,Vincent Davis*,Pitt,ACC,14,142,593,4.2,4,23,125,5.4,0,165,718,4.4,4,vincent-davis-3
204,Jahmyl Jeter,Texas State,Sun Belt,12,91,384,4.2,8,10,29,2.9,0,101,413,4.1,8,jahmyl-jeter-1
205,Marcus Williams Jr.,Louisiana Tech,CUSA,12,194,787,4.1,8,20,202,10.1,1,214,989,4.6,9,marcus-williams-12
206,Joshua Mack*,Liberty,Ind,11,109,448,4.1,3,4,15,3.8,0,113,463,4.1,3,joshua-mack-1
207,Mike Wright,Vanderbilt,SEC,10,91,373,4.1,1,0,0,,0,91,373,4.1,1,mike-wright-8
208,Alec Sinkfield,Boston College,ACC,12,85,350,4.1,2,1,6,6.0,0,86,356,4.1,2,alec-sinkfield-1
209,Matt Corral*,Ole Miss,SEC,13,152,614,4.0,11,1,19,19.0,0,153,633,4.1,11,matt-corral-1
210,Jordan Travis,Florida State,ACC,10,134,530,4.0,7,0,-13,,0,134,517,3.9,7,jordan-travis-1
211,Christian Turner*,Wake Forest,ACC,14,126,506,4.0,5,4,29,7.3,0,130,535,4.1,5,christian-turner-1
212,Bobby Cole,New Mexico,MWC,11,88,355,4.0,2,10,29,2.9,0,98,384,3.9,2,bobby-cole-3
213,Isiah Pacheco*,Rutgers,Big Ten,12,167,647,3.9,5,13,25,1.9,0,180,672,3.7,5,isaih-pacheco-1
214,Isaac Ruoss,Navy,American,12,166,641,3.9,5,2,15,7.5,0,168,656,3.9,5,isaac-ruoss-1
215,Stephen Carr,Indiana,Big Ten,9,155,600,3.9,6,15,93,6.2,1,170,693,4.1,7,stephen-carr-2
216,Jaylan Knighton,Miami (FL),ACC,8,145,561,3.9,8,20,280,14.0,3,165,841,5.1,11,jaylan-knighton-1
217,King Doerue*,Purdue,Big Ten,12,135,533,3.9,2,20,156,7.8,0,155,689,4.4,2,king-doerue-1
218,Adrian Martinez,Nebraska,Big Ten,11,133,525,3.9,13,0,0,,0,133,525,3.9,13,adrian-martinez-2
219,Tyhier Tyler*,Army,Ind,12,128,494,3.9,7,0,0,,0,128,494,3.9,7,tyhier-tyler-1
220,Sean McGrew,Washington,Pac-12,8,110,434,3.9,8,8,51,6.4,0,118,485,4.1,8,sean-mcgrew-1
221,Jo'quavious Marks*,Mississippi State,SEC,13,106,416,3.9,6,83,502,6.0,3,189,918,4.9,9,joquavious-marks-1
222,B.J. Smith,Troy,Sun Belt,11,95,372,3.9,4,21,147,7.0,0,116,519,4.5,4,bj-smith-1
223,Devonte Lee*,Nevada,MWC,13,85,331,3.9,5,19,98,5.2,1,104,429,4.1,6,devonte-lee-1
224,O'Shaan Allison,Ohio,MAC,10,82,317,3.9,0,20,157,7.9,1,102,474,4.6,1,oshaan-allison-1
225,Justin Lynch,Temple,American,11,75,295,3.9,1,0,0,,0,75,295,3.9,1,justin-lynch-1
226,David Bailey,Colorado State,MWC,11,197,752,3.8,9,15,134,8.9,2,212,886,4.2,11,david-bailey-4
227,Deion Hankins*,UTEP,CUSA,11,121,458,3.8,6,4,24,6.0,0,125,482,3.9,6,deion-hankins-1
228,Darius Boone Jr.*,Eastern Michigan,MAC,13,120,451,3.8,6,5,77,15.4,0,125,528,4.2,6,darius-boone-jr-1
229,Kevin Marks,Buffalo,MAC,10,108,414,3.8,5,8,25,3.1,0,116,439,3.8,5,kevin-marks-1
230,James Harris II,Navy,American,12,99,373,3.8,2,0,0,,0,99,373,3.8,2,james-harris-ll-1
231,Bryan Hill,South Alabama,Sun Belt,10,88,332,3.8,3,5,30,6.0,0,93,362,3.9,3,bryan-hill-2
232,Samson Evans*,Eastern Michigan,MAC,12,83,316,3.8,13,19,107,5.6,0,102,423,4.1,13,samson-evans-1
233,Hendon Hooker*,Tennessee,SEC,13,166,616,3.7,5,0,0,,0,166,616,3.7,5,hendon-hooker-1
234,Terrion Avery,South Alabama,Sun Belt,12,138,508,3.7,1,18,93,5.2,3,156,601,3.9,4,terrion-avery-1
235,Andrew Henry,Louisiana-Monroe,Sun Belt,11,131,482,3.7,4,14,88,6.3,1,145,570,3.9,5,andrew-henry-2
236,Jordan Myers,Rice,CUSA,11,92,338,3.7,8,27,278,10.3,1,119,616,5.2,9,jordan-myers-1
237,Edward Saydee,Temple,American,11,87,321,3.7,3,14,135,9.6,0,101,456,4.5,3,edward-saydee-1
238,Jakobi Buchanan*,Army,Ind,14,157,572,3.6,13,0,0,,0,157,572,3.6,13,jakobi-buchanan-1
239,Rocko Griffin,Vanderbilt,SEC,11,145,517,3.6,4,10,41,4.1,0,155,558,3.6,4,rocko-griffin-1
240,A'Jon Vivens,Colorado State,MWC,9,90,324,3.6,0,10,73,7.3,0,100,397,4.0,0,ajon-vivens-1
241,Will Jones*,Ball State,MAC,13,88,314,3.6,3,16,131,8.2,0,104,445,4.3,3,will-jones-3
242,Cameron Davis,Washington,Pac-12,12,85,308,3.6,2,14,115,8.2,0,99,423,4.3,2,cameron-davis-3
243,Rahjai Harris,East Carolina,American,12,165,583,3.5,4,24,162,6.8,1,189,745,3.9,5,rahjai-harris-1
244,Khalan Griffin,Rice,CUSA,12,114,400,3.5,2,1,20,20.0,0,115,420,3.7,2,khalan-griffin-1
245,Austin Jones,Stanford,Pac-12,11,107,378,3.5,2,32,267,8.3,1,139,645,4.6,3,austin-jones-6
246,Will Levis*,Kentucky,SEC,13,107,376,3.5,9,1,15,15.0,0,108,391,3.6,9,will-levis-1
247,Cyrus Habibi-Likio,Boise State,MWC,11,107,374,3.5,2,23,213,9.3,0,130,587,4.5,2,cyrus-habibi-likio-1
248,Alexander Horvath*,Purdue,Big Ten,8,91,320,3.5,3,17,108,6.4,0,108,428,4.0,3,alexander-horvath-1
249,Todd Centeio,Colorado State,MWC,12,131,439,3.4,2,1,12,12.0,0,132,451,3.4,2,todd-centeio-1
250,Max Duggan,TCU,Big 12,10,105,352,3.4,3,0,0,,0,105,352,3.4,3,max-duggan-1
251,Levi Lewis*,Louisiana,Sun Belt,14,100,343,3.4,5,0,0,,0,100,343,3.4,5,levi-lewis-1
252,Alex Fontenot,Colorado,Pac-12,12,96,326,3.4,5,13,80,6.2,1,109,406,3.7,6,alex-fontenot-1
253,Kareem Walker,South Alabama,Sun Belt,8,86,295,3.4,4,12,43,3.6,1,98,338,3.4,5,kareem-walker-1
254,Desmond Ridder*,Cincinnati,American,14,110,365,3.3,6,2,8,4.0,2,112,373,3.3,8,desmond-ridder-1
255,Noah Cain*,Penn State,Big Ten,13,106,350,3.3,4,19,114,6.0,0,125,464,3.7,4,noah-cain-1
256,Michael Wiley,Arizona,Pac-12,11,91,302,3.3,2,33,297,9.0,4,124,599,4.8,6,michael-wiley-3
257,Demarcus Irons Jr.,Akron,MAC,8,91,296,3.3,2,0,0,,0,91,296,3.3,2,demarcus-irons-jr-1
258,Sam Hartman*,Wake Forest,ACC,14,117,363,3.1,11,1,3,3.0,0,118,366,3.1,11,sam-hartman-1
259,Grayson McCall*,Coastal Carolina,Sun Belt,11,93,290,3.1,4,0,0,,0,93,290,3.1,4,grayson-mccall-1
260,Kevin Mensah,Connecticut,Ind,12,104,314,3.0,0,12,55,4.6,0,116,369,3.2,0,kevin-mensah-1
261,Chevan Cordeiro,Hawaii,MWC,11,116,342,2.9,3,0,0,,0,116,342,2.9,3,chevan-cordeiro-1
262,D.J. Uiagalelei*,Clemson,ACC,13,105,308,2.9,4,0,0,,0,105,308,2.9,4,dj-uiagalelei-1
263,Noah Vedral*,Rutgers,Big Ten,13,102,297,2.9,2,0,0,,0,102,297,2.9,2,noah-vedral-1
264,Brock Purdy*,Iowa State,Big 12,13,85,238,2.8,1,0,0,,0,85,238,2.8,1,brock-purdy-1
265,Chandler Rogers,Louisiana-Monroe,Sun Belt,12,139,367,2.6,1,0,0,,0,139,367,2.6,1,chandler-rogers-3
266,Brennan Armstrong,Virginia,ACC,11,98,251,2.6,9,1,18,18.0,1,99,269,2.7,10,brennan-armstrong-1
267,Kenny Pickett*,Pitt,ACC,13,97,241,2.5,5,0,0,,0,97,241,2.5,5,kenny-pickett-1
268,Justin Tomlin,Georgia Southern,Sun Belt,8,80,195,2.4,2,0,0,,0,80,195,2.4,2,justin-tomlin-1
269,Tai Lavatai,Navy,American,10,170,371,2.2,7,0,0,,0,170,371,2.2,7,tai-lavatai-1
270,Payton Thorne*,Michigan State,Big Ten,13,82,181,2.2,4,1,15,15.0,0,83,196,2.4,4,payton-thorne-1
271,Timmy Mcclain,South Florida,American,11,123,238,1.9,4,0,0,,0,123,238,1.9,4,timmy-mcclain-1
272,Brendon Lewis,Colorado,Pac-12,12,98,188,1.9,2,0,0,,0,98,188,1.9,2,brendon-lewis-1
273,Chris Reynolds,Charlotte,CUSA,11,86,164,1.9,4,0,0,,0,86,164,1.9,4,chris-reynolds-1
274,Holton Ahlers,East Carolina,American,12,116,204,1.8,6,2,27,13.5,1,118,231,2.0,7,holton-ahlers-1
275,Gunnar Holmberg,Duke,ACC,11,88,161,1.8,6,0,0,,0,88,161,1.8,6,gunnar-holmberg-1
276,Seth Henigan,Memphis,American,11,80,147,1.8,0,1,8,8.0,0,81,155,1.9,0,seth-henigan-1
277,Brady McBride,Texas State,Sun Belt,7,77,141,1.8,1,0,0,,0,77,141,1.8,1,brady-mcbride-1
278,Sean Clifford*,Penn State,Big Ten,13,99,163,1.6,2,0,0,,0,99,163,1.6,2,sean-clifford-1
279,Clayton Tune*,Houston,American,14,105,154,1.5,2,0,0,,0,105,154,1.5,2,clayton-tune-1
280,Michael Pratt,Tulane,American,12,105,152,1.4,5,0,0,,0,105,152,1.4,5,michael-pratt-1
281,N'Kosi Perry,Florida Atlantic,CUSA,12,107,148,1.4,4,1,20,20.0,1,108,168,1.6,5,nkosi-perry-1
282,Jonah Johnson,New Mexico State,Ind,11,130,158,1.2,4,0,0,,0,130,158,1.2,4,jonah-johnson-1
283,Kaleb Eleby*,Western Michigan,MAC,13,87,64,0.7,6,0,0,,1,87,64,0.7,7,kaleb-eleby-1
284,Dylan Hopkins*,UAB,CUSA,13,85,19,0.2,5,0,0,,0,85,19,0.2,5,dylan-hopkins-1
285,Matt McDonald,Bowling Green State,MAC,12,80,13,0.2,4,0,0,,0,80,13,0.2,4,matt-mcdonald-1
286,Ben Bryant*,Eastern Michigan,MAC,13,87,-43,-0.5,2,0,0,,0,87,-43,-0.5,2,ben-bryant-1