Rk,Player,School,Conf,G,Att,Yds,Avg,TD,Rec,Yds,Avg,TD,Plays,Yds,Avg,TD,-9999
1,Lynn Bowden Jr.*,Kentucky,SEC,13,185,1468,7.9,13,30,348,11.6,1,215,1816,8.4,14,lynn-bowden-jr-1
2,Travis Etienne*,Clemson,ACC,15,207,1614,7.8,19,37,432,11.7,4,244,2046,8.4,23,travis-etienne-1
3,Raymond Calais*,Louisiana,Sun Belt,14,117,886,7.6,6,10,67,6.7,1,127,953,7.5,7,raymond-calais-1
4,Javon Leake,Maryland,Big Ten,12,102,736,7.2,8,9,55,6.1,0,111,791,7.1,8,javon-leake-1
5,Adrian Killins*,UCF,American,12,87,629,7.2,7,8,120,15.0,1,95,749,7.9,8,adrian-killins-1
6,Jason Huntley,New Mexico State,Ind,12,154,1090,7.1,9,40,192,4.8,2,194,1282,6.6,11,jason-huntley-1
7,Trey Ragas*,Louisiana,Sun Belt,13,116,820,7.1,11,6,60,10.0,1,122,880,7.2,12,trey-ragas-1
8,Malcolm Davidson*,Florida Atlantic,CUSA,11,102,711,7.0,9,4,46,11.5,0,106,757,7.1,9,malcolm-davidson-1
9,Journey Brown*,Penn State,Big Ten,13,129,890,6.9,12,15,134,8.9,1,144,1024,7.1,13,journey-brown-1
10,Wesley Kennedy III*,Georgia Southern,Sun Belt,9,119,824,6.9,11,10,92,9.2,0,129,916,7.1,11,wesley-kennedy-iii-1
11,Jerrion Ealy,Ole Miss,SEC,12,104,722,6.9,6,20,172,8.6,1,124,894,7.2,7,jerrion-ealy-1
12,Bentavious Thompson*,UCF,American,12,87,604,6.9,8,5,25,5.0,0,92,629,6.8,8,bentavious-thompson-1
13,Bentavious Thompson*,UCF,American,13,87,604,6.9,8,5,25,5.0,0,92,629,6.8,8,bentavious-thompson-2
14,Malcolm Perry*,Navy,American,13,295,2017,6.8,21,0,0,,0,295,2017,6.8,21,malcolm-perry-1
15,J.K. Dobbins*,Ohio State,Big Ten,14,301,2003,6.7,21,23,247,10.7,2,324,2250,6.9,23,jk-dobbins-1
16,Destin Coates*,Georgia State,Sun Belt,11,82,546,6.7,7,7,60,8.6,0,89,606,6.8,7,destin-coates-1
17,Clyde Edwards-Helaire*,LSU,SEC,15,215,1414,6.6,16,55,453,8.2,1,270,1867,6.9,17,clyde-edwards-helaire-1
18,John Rhys Plumlee,Ole Miss,SEC,9,154,1023,6.6,12,0,0,,0,154,1023,6.6,12,john-rhys-plumlee-1
19,Jamale Carothers*,Navy,American,10,111,734,6.6,14,4,105,26.3,2,115,839,7.3,16,jamale-carothers-2
20,Josh Johnson,Louisiana-Monroe,Sun Belt,12,201,1298,6.5,11,13,122,9.4,0,214,1420,6.6,11,josh-johnson-8
21,Kennedy Brooks*,Oklahoma,Big 12,13,155,1011,6.5,6,10,79,7.9,0,165,1090,6.6,6,kennedy-brooks-1
22,Chuba Hubbard*,Oklahoma State,Big 12,13,328,2094,6.4,21,23,198,8.6,0,351,2292,6.5,21,chuba-hubbard-1
23,Max Borghi*,Washington State,Pac-12,13,127,817,6.4,11,86,597,6.9,5,213,1414,6.6,16,max-borghi-1
24,Otis Anderson*,UCF,American,13,113,726,6.4,5,31,365,11.8,3,144,1091,7.6,8,otis-anderson-1
25,John Lovett*,Baylor,Big 12,14,103,655,6.4,5,8,66,8.3,0,111,721,6.5,5,john-lovett-1
26,De'Montre Tuggle*,Ohio,MAC,12,101,644,6.4,11,16,121,7.6,1,117,765,6.5,12,demontre-tuggle-1
27,Jonathan Taylor*,Wisconsin,Big Ten,14,320,2003,6.3,21,26,252,9.7,5,346,2255,6.5,26,jonathan-taylor-1
28,Kenny Gainwell*,Memphis,American,14,231,1459,6.3,13,51,610,12.0,3,282,2069,7.3,16,kenny-gainwell-1
29,O'Shaan Allison*,Ohio,MAC,12,138,869,6.3,6,11,76,6.9,0,149,945,6.3,6,oshaan-allison-1
30,Sean Chambers*,Wyoming,MWC,8,90,567,6.3,10,0,0,,0,90,567,6.3,10,sean-chambers-1
31,Snoop Conner,Ole Miss,SEC,12,81,512,6.3,5,6,60,10.0,0,87,572,6.6,5,snoop-conner-1
32,CJ Verdell*,Oregon,Pac-12,14,197,1220,6.2,8,14,125,8.9,0,211,1345,6.4,8,cj-verdell-1
33,D'Andre Swift*,Georgia,SEC,14,196,1218,6.2,7,24,216,9.0,1,220,1434,6.5,8,dandre-swift-1
34,Rakeem Boyd,Arkansas,SEC,12,184,1133,6.2,8,19,160,8.4,0,203,1293,6.4,8,rakeem-boyd-2
35,Travis Dye*,Oregon,Pac-12,14,106,658,6.2,0,16,159,9.9,1,122,817,6.7,1,travis-dye-1
36,Bryant Koback,Toledo,MAC,12,195,1187,6.1,12,8,69,8.6,2,203,1256,6.2,14,bryant-koback-1
37,Jonathan Ward*,Central Michigan,MAC,12,183,1108,6.1,15,34,329,9.7,1,217,1437,6.6,16,jonathan-ward-3
38,Timothy Jackson*,Air Force,MWC,10,122,745,6.1,6,1,-2,-2.0,0,123,743,6.0,6,timothy-jackson-1
39,Lyn-J Dixon*,Clemson,ACC,15,104,635,6.1,6,14,121,8.6,0,118,756,6.4,6,lyn-j-dixon-1
40,Kavosiey Smoke*,Kentucky,SEC,13,101,616,6.1,6,2,26,13.0,0,103,642,6.2,6,kavosiey-smoke-1
41,Zack Moss*,Utah,Pac-12,13,235,1416,6.0,15,28,388,13.9,2,263,1804,6.9,17,zack-moss-1
42,Art Pierce,Oregon State,Pac-12,12,146,873,6.0,6,23,169,7.3,1,169,1042,6.2,7,art-pierce-1
43,Tony Jones Jr.*,Notre Dame,Ind,12,144,857,6.0,6,15,104,6.9,1,159,961,6.0,7,tony-jones-jr-1
44,Deejay Dallas*,Miami (FL),ACC,10,115,693,6.0,8,14,140,10.0,2,129,833,6.5,10,deejay-dallas-1
45,Tra Barnett*,Georgia State,Sun Belt,13,248,1453,5.9,12,16,69,4.3,0,264,1522,5.8,12,tra-barnett-1
46,Charles Williams,UNLV,MWC,12,212,1257,5.9,11,7,54,7.7,0,219,1311,6.0,11,charles-williams-8
47,Najee Harris*,Alabama,SEC,13,209,1224,5.9,13,27,304,11.3,7,236,1528,6.5,20,najee-harris-1
48,Kobe Lewis*,Central Michigan,MAC,14,182,1074,5.9,12,23,164,7.1,0,205,1238,6.0,12,kobe-lewis-1
49,Keaontay Ingram*,Texas,Big 12,13,144,853,5.9,7,29,242,8.3,3,173,1095,6.3,10,keaontay-ingram-1
50,Ahmari Davis,New Mexico,MWC,9,140,832,5.9,7,3,63,21.0,0,143,895,6.3,7,ahmari-davis-1
51,Kenneth Walker III*,Wake Forest,ACC,13,98,579,5.9,4,3,17,5.7,0,101,596,5.9,4,kenneth-walker-iii-1
52,Jaret Patterson*,Buffalo,MAC,13,312,1799,5.8,19,13,209,16.1,1,325,2008,6.2,20,jaret-patterson-1
53,Javian Hawkins*,Louisville,ACC,13,264,1525,5.8,9,4,58,14.5,0,268,1583,5.9,9,javian-hawkins-1
54,Darrynton Evans*,Appalachian State,Sun Belt,14,255,1480,5.8,18,21,198,9.4,5,276,1678,6.1,23,darrynton-evans-1
55,Elijah Mitchell*,Louisiana,Sun Belt,14,198,1147,5.8,16,10,70,7.0,1,208,1217,5.9,17,elijah-mitchell-2
56,Kadin Remsberg*,Air Force,MWC,13,181,1050,5.8,8,3,24,8.0,0,184,1074,5.8,8,kadin-remsberg-1
57,DK Billingsley,Troy,Sun Belt,12,155,901,5.8,10,25,211,8.4,0,180,1112,6.2,10,dk-billingsley-1
58,Master Teague*,Ohio State,Big Ten,13,135,789,5.8,4,4,60,15.0,0,139,849,6.1,4,master-teague-1
59,Joshua Mack*,Liberty,Ind,13,133,774,5.8,7,13,177,13.6,0,146,951,6.5,7,joshua-mack-1
60,Marvin Kinsey,Colorado State,MWC,7,121,703,5.8,6,16,209,13.1,2,137,912,6.7,8,marvin-kinsey-1
61,Marcus Williams Jr.*,Appalachian State,Sun Belt,14,113,652,5.8,5,1,7,7.0,0,114,659,5.8,5,marcus-williams-12
62,JaMycal Hasty*,Baylor,Big 12,14,109,627,5.8,7,25,184,7.4,0,134,811,6.1,7,jamycal-hasty-1
63,Michael Carter*,North Carolina,ACC,13,177,1003,5.7,3,21,154,7.3,2,198,1157,5.8,5,michael-carter-5
64,David Bailey*,Boston College,ACC,13,148,844,5.7,7,10,94,9.4,1,158,938,5.9,8,david-bailey-4
65,Caleb Evans,Louisiana-Monroe,Sun Belt,12,140,794,5.7,12,0,0,,0,140,794,5.7,12,caleb-evans-2
66,Kylin Hill*,Mississippi State,SEC,13,242,1350,5.6,10,18,180,10.0,1,260,1530,5.9,11,kylin-hill-1
67,Jalen Hurts*,Oklahoma,Big 12,14,233,1298,5.6,20,2,25,12.5,1,235,1323,5.6,21,jalen-hurts-1
68,Ben LeMay*,Charlotte,CUSA,11,193,1082,5.6,9,19,242,12.7,4,212,1324,6.2,13,ben-lemay-1
69,Justin Henderson*,Louisiana Tech,CUSA,13,188,1062,5.6,15,24,200,8.3,1,212,1262,6.0,16,justin-henderson-2
70,Frankie Hickson*,Liberty,Ind,13,187,1041,5.6,12,11,96,8.7,1,198,1137,5.7,13,frankie-hickson-1
71,Sincere McCormick,UTSA,CUSA,12,177,983,5.6,8,24,194,8.1,1,201,1177,5.9,9,sincere-mccormick-1
72,Javonte Williams*,North Carolina,ACC,13,166,933,5.6,5,17,176,10.4,1,183,1109,6.1,6,javonte-williams-1
73,Nathan Rourke*,Ohio,MAC,13,154,867,5.6,13,1,2,2.0,1,155,869,5.6,14,nathan-rourke-1
74,Tre Siggers,North Texas,CUSA,10,152,853,5.6,6,11,60,5.5,0,163,913,5.6,6,tre-siggers-1
75,LeVante Bellamy*,Western Michigan,MAC,13,266,1472,5.5,23,15,55,3.7,0,281,1527,5.4,23,levante-bellamy-1
76,Tra Minter,South Alabama,Sun Belt,12,193,1057,5.5,5,32,209,6.5,0,225,1266,5.6,5,tra-minter-1
77,Asim Rose*,Kentucky,SEC,13,149,826,5.5,6,11,67,6.1,0,160,893,5.6,6,asim-rose-1
78,Darius Anderson,TCU,Big 12,12,151,823,5.5,6,22,128,5.8,0,173,951,5.5,6,darius-anderson-1
79,Zonovan Knight,North Carolina State,ACC,12,136,745,5.5,5,7,45,6.4,0,143,790,5.5,5,zonovan-knight-1
80,Walter Fletcher,Ball State,MAC,12,132,726,5.5,5,26,306,11.8,2,158,1032,6.5,7,walter-fletcher-1
81,Trevor Lawrence*,Clemson,ACC,15,103,563,5.5,9,1,0,0.0,0,104,563,5.4,9,trevor-lawrence-1
82,Salvon Ahmed*,Washington,Pac-12,12,188,1020,5.4,11,16,84,5.3,0,204,1104,5.4,11,salvon-ahmed-1
83,Isaiah Spiller*,Texas A&M,SEC,13,174,946,5.4,10,29,203,7.0,0,203,1149,5.7,10,isaiah-spiller-1
84,Tavien Feaster,South Carolina,SEC,10,124,672,5.4,5,17,87,5.1,0,141,759,5.4,5,tavien-feaster-1
85,Anthony McFarland,Maryland,Big Ten,11,114,614,5.4,8,17,126,7.4,1,131,740,5.6,9,anthony-mcfarland-2
86,Tyre Shelton*,Miami (OH),MAC,14,108,587,5.4,2,13,78,6.0,0,121,665,5.5,2,tyre-shelton-1
87,Greg McCrae*,UCF,American,10,98,529,5.4,7,9,64,7.1,0,107,593,5.5,7,greg-mccrae-1
88,AJ Dillon*,Boston College,ACC,13,318,1685,5.3,14,13,195,15.0,1,331,1880,5.7,15,aj-dillon-1
89,C.J. Marable,Coastal Carolina,Sun Belt,12,204,1085,5.3,11,38,295,7.8,3,242,1380,5.7,14,torrance-marable-1
90,Asher O'Hara,Middle Tennessee State,CUSA,12,199,1058,5.3,9,0,-5,,0,199,1053,5.3,9,asher-ohara-1
91,George Holani*,Boise State,MWC,14,192,1014,5.3,7,26,206,7.9,3,218,1220,5.6,10,george-holani-1
92,Aston Walter,Rice,CUSA,11,145,771,5.3,8,11,48,4.4,2,156,819,5.3,10,aston-walter-1
93,Napoleon Maxwell*,Florida International,CUSA,13,128,675,5.3,9,13,94,7.2,0,141,769,5.5,9,napoleon-maxwell-1
94,Roschon Johnson*,Texas,Big 12,13,123,649,5.3,7,23,158,6.9,1,146,807,5.5,8,roschon-johnson-1
95,Mohamed Ibrahim*,Minnesota,Big Ten,11,114,604,5.3,7,3,13,4.3,0,117,617,5.3,7,mohamed-ibrahim-1
96,Kevin Perkins*,Southern Mississippi,CUSA,13,103,547,5.3,3,7,46,6.6,0,110,593,5.4,3,kevin-perkins-1
97,Eric Gray*,Tennessee,SEC,13,101,539,5.3,4,13,115,8.8,1,114,654,5.7,5,eric-gray-2
98,Gerrid Doaks*,Cincinnati,American,12,100,526,5.3,5,8,70,8.8,1,108,596,5.5,6,gerrid-doaks-1
99,Noah Cain*,Penn State,Big Ten,10,84,443,5.3,8,7,52,7.4,0,91,495,5.4,8,noah-cain-1
100,Xavier Jones*,SMU,American,13,244,1276,5.2,23,20,90,4.5,2,264,1366,5.2,25,xavier-jones-2
101,Pooka Williams,Kansas,Big 12,11,203,1061,5.2,3,27,214,7.9,2,230,1275,5.5,5,pooka-williams-1
102,Ke'Shawn Vaughn,Vanderbilt,SEC,12,198,1028,5.2,9,29,286,9.9,1,227,1314,5.8,10,keshawn-vaughn-1
103,Miles Reed*,Hawaii,MWC,15,174,908,5.2,8,3,16,5.3,0,177,924,5.2,8,miles-reed-1
104,Jordan Mason,Georgia Tech,ACC,12,172,899,5.2,7,7,43,6.1,0,179,942,5.3,7,jordan-mason-1
105,Chris Reynolds*,Charlotte,CUSA,13,153,791,5.2,6,1,28,28.0,0,154,819,5.3,6,chris-reynolds-1
106,Dedrick Mills,Nebraska,Big Ten,12,143,745,5.2,10,15,123,8.2,0,158,868,5.5,10,dedrick-mills-1
107,James Gilbert*,Kansas State,Big 12,11,141,737,5.2,6,6,49,8.2,0,147,786,5.3,6,james-gilbert-2
108,Garrett Shrader*,Mississippi State,SEC,10,113,587,5.2,6,0,0,,0,113,587,5.2,6,garrett-shrader-1
109,Dre Brown*,Illinois,Big Ten,13,113,584,5.2,5,10,82,8.2,0,123,666,5.4,5,dre-brown-1
110,Jordan Houston,North Carolina State,ACC,12,101,526,5.2,2,15,112,7.5,0,116,638,5.5,2,jordan-houston-1
111,Brenden Knox*,Marshall,CUSA,13,270,1387,5.1,11,14,129,9.2,0,284,1516,5.3,11,brenden-knox-1
112,Caleb Huntley,Ball State,MAC,12,248,1275,5.1,12,7,25,3.6,0,255,1300,5.1,12,caleb-huntley-1
113,Xazavian Valladay*,Wyoming,MWC,12,247,1265,5.1,6,11,211,19.2,2,258,1476,5.7,8,xazavian-valladay-1
114,Rodney Smith*,Minnesota,Big Ten,13,228,1163,5.1,8,7,70,10.0,0,235,1233,5.2,8,rodney-smith-5
115,Gerold Bright*,Utah State,MWC,13,182,921,5.1,9,35,230,6.6,1,217,1151,5.3,10,gerold-bright-1
116,Ronnie Rivers,Fresno State,MWC,12,177,899,5.1,13,43,348,8.1,3,220,1247,5.7,16,ronnie-rivers-1
117,Bilal Ally,Massachusetts,Ind,12,166,853,5.1,7,7,32,4.6,0,173,885,5.1,7,bilal-ally-1
118,Kelvin Hopkins Jr.,Army,Ind,11,138,710,5.1,7,0,0,,0,138,710,5.1,7,kelvin-hopkins-jr-1
119,Lamical Perine*,Florida,SEC,13,132,676,5.1,6,40,262,6.6,5,172,938,5.5,11,lamical-perine-1
120,Hassan Haskins*,Michigan,Big Ten,13,121,622,5.1,4,6,40,6.7,0,127,662,5.2,4,hassan-haskins-1
121,Cam'ron Harris*,Miami (FL),ACC,13,114,576,5.1,5,16,118,7.4,1,130,694,5.3,6,camron-harris-1
122,Jaylen Warren*,Utah State,MWC,12,112,569,5.1,5,15,182,12.1,0,127,751,5.9,5,jaylen-warren-1
123,Bryson Carroll,New Mexico,MWC,10,105,536,5.1,2,2,12,6.0,0,107,548,5.1,2,bryson-carroll-1
124,Gaej Walker*,Western Kentucky,CUSA,13,241,1208,5.0,8,24,140,5.8,0,265,1348,5.1,8,gaej-walker-1
125,Cam Akers*,Florida State,ACC,11,231,1144,5.0,14,30,225,7.5,4,261,1369,5.2,18,cam-akers-1
126,Moe Neal,Syracuse,ACC,12,170,846,5.0,7,29,242,8.3,0,199,1088,5.5,7,moe-neal-1
127,Jordan Cronkrite,South Florida,American,10,136,686,5.0,4,15,134,8.9,0,151,820,5.4,4,jordan-cronkrite-1
128,JaTarvious Whitlow*,Auburn,SEC,11,156,763,4.9,10,6,106,17.7,0,162,869,5.4,10,jatarvious-whitlow-1
129,Zach Charbonnet*,Michigan,Big Ten,13,149,726,4.9,11,8,30,3.8,0,157,756,4.8,11,zach-charbonnet-1
130,J.J. Taylor,Arizona,Pac-12,11,148,721,4.9,5,32,289,9.0,0,180,1010,5.6,5,jj-taylor-1
131,Ty Chandler*,Tennessee,SEC,13,135,655,4.9,3,13,63,4.8,0,148,718,4.9,3,ty-chandler-1
132,Nelson Smith*,Navy,American,13,116,571,4.9,7,0,0,,0,116,571,4.9,7,nelson-smith-1
133,Ian Book*,Notre Dame,Ind,13,112,546,4.9,4,0,0,,0,112,546,4.9,4,ian-book-1
134,Bryson Denley,Bowling Green State,MAC,12,111,544,4.9,4,27,267,9.9,3,138,811,5.9,7,bryson-denley-1
135,Christian Gibson,New Mexico State,Ind,12,99,489,4.9,3,10,54,5.4,0,109,543,5.0,3,christian-gibson-1
136,Michael Warren II*,Cincinnati,American,14,261,1265,4.8,14,21,153,7.3,2,282,1418,5.0,16,michael-warren-ii-1
137,Re'Mahn Davis*,Temple,American,12,193,936,4.8,8,15,181,12.1,2,208,1117,5.4,10,remahn-davis-1
138,Breece Hall*,Iowa State,Big 12,12,186,897,4.8,9,23,252,11.0,1,209,1149,5.5,10,breece-hall-1
139,Deshawn McClease*,Virginia Tech,ACC,13,177,843,4.8,7,11,70,6.4,0,188,913,4.9,7,deshawn-mcclease-1
140,Marcel Murray*,Arkansas State,Sun Belt,11,170,820,4.8,6,15,125,8.3,0,185,945,5.1,6,marcel-murray-1
141,SaRodorick Thompson,Texas Tech,Big 12,12,160,765,4.8,12,39,154,3.9,0,199,919,4.6,12,sarodorick-thompson-1
142,Shakif Seymour,Toledo,MAC,12,154,741,4.8,5,16,124,7.8,1,170,865,5.1,6,shakif-seymour-1
143,Shaq Vann*,Eastern Michigan,MAC,10,149,715,4.8,8,11,66,6.0,0,160,781,4.9,8,shaq-vann-1
144,Jermar Jefferson,Oregon State,Pac-12,9,142,685,4.8,8,9,85,9.4,2,151,770,5.1,10,jermar-jefferson-1
145,Tyler Goodson*,Iowa,Big Ten,13,134,638,4.8,5,24,166,6.9,0,158,804,5.1,5,tyler-goodson-1
146,De'Michael Harris*,Southern Mississippi,CUSA,12,113,541,4.8,5,34,346,10.2,3,147,887,6.0,8,demichael-harris-1
147,Vavae Malepeai*,USC,Pac-12,8,105,503,4.8,6,15,70,4.7,1,120,573,4.8,7,vavae-malepeai-1
148,Brian Herrien*,Georgia,SEC,12,103,490,4.8,6,16,110,6.9,1,119,600,5.0,7,brian-herrien-1
149,Art Thompkins,Connecticut,American,12,98,468,4.8,2,39,257,6.6,2,137,725,5.3,4,art-thompkins-1
150,Mataeo Durant,Duke,ACC,12,97,461,4.8,1,16,117,7.3,1,113,578,5.1,2,mataeo-durant-1
151,Robert Mahone*,Boise State,MWC,12,89,425,4.8,6,9,76,8.4,0,98,501,5.1,6,robert-mahone-1
152,D.J. Williams*,Auburn,SEC,8,84,400,4.8,2,5,32,6.4,0,89,432,4.9,2,dj-williams-7
153,DJ Williams*,Auburn,SEC,9,84,400,4.8,2,5,32,6.4,0,89,432,4.9,2,dj-williams-9
154,Alexander Horvath,Purdue,Big Ten,11,79,377,4.8,2,17,142,8.4,1,96,519,5.4,3,alexander-horvath-1
155,Alex Fontenot,Colorado,Pac-12,11,185,874,4.7,5,27,122,4.5,0,212,996,4.7,5,alex-fontenot-1
156,Stevie Scott*,Indiana,Big Ten,11,178,845,4.7,10,26,211,8.1,1,204,1056,5.2,11,stevie-scott-1
157,Taven Birdow*,Air Force,MWC,13,180,839,4.7,7,1,16,16.0,0,181,855,4.7,7,taven-birdow-1
158,Reggie Corbin*,Illinois,Big Ten,12,143,675,4.7,7,3,28,9.3,0,146,703,4.8,7,reggie-corbin-1
159,Kyle Porter,Houston,American,11,130,616,4.7,3,13,128,9.8,1,143,744,5.2,4,kyle-porter-1
160,Mekhi Sargent*,Iowa,Big Ten,13,119,563,4.7,4,14,138,9.9,0,133,701,5.3,4,mekhi-sargent-1
161,Rico Dowdle,South Carolina,SEC,10,106,498,4.7,4,22,167,7.6,0,128,665,5.2,4,rico-dowdle-1
162,Joshua Kelley,UCLA,Pac-12,11,229,1060,4.6,12,11,71,6.5,1,240,1131,4.7,13,joshua-kelley-1
163,Shamari Brooks,Tulsa,American,12,227,1046,4.6,6,9,49,5.4,1,236,1095,4.6,7,shamari-brooks-1
164,Kevin Marks*,Buffalo,MAC,13,227,1035,4.6,8,12,41,3.4,0,239,1076,4.5,8,kevin-marks-1
165,Anthony Jones*,Florida International,CUSA,12,187,867,4.6,9,10,123,12.3,2,197,990,5.0,11,anthony-jones-8
166,Will Matthews*,Kent State,MAC,8,123,570,4.6,3,7,70,10.0,0,130,640,4.9,3,will-mathews-1
167,Donald Hammond III*,Air Force,MWC,13,121,553,4.6,13,1,22,22.0,0,122,575,4.7,13,donald-hammond-iii-1
168,Hassan Hall*,Louisville,ACC,13,108,501,4.6,5,5,51,10.2,0,113,552,4.9,5,hassan-hall-1
169,Brian Robinson Jr.*,Alabama,SEC,13,96,441,4.6,5,11,124,11.3,0,107,565,5.3,5,brian-robinson-jr-1
170,Lucious Stanley*,UAB,CUSA,12,90,414,4.6,7,8,74,9.3,1,98,488,5.0,8,lucious-stanley-1
171,Khalil Tate,Arizona,Pac-12,11,90,413,4.6,3,0,0,,0,90,413,4.6,3,khalil-tate-1
172,Xavier Williams*,Kent State,MAC,11,86,393,4.6,4,5,105,21.0,2,91,498,5.5,6,xavier-williams-2
173,Tommy Stevens*,Mississippi State,SEC,9,83,381,4.6,4,0,0,,0,83,381,4.6,4,tommy-stevens-1
174,Marcus McElroy,Colorado State,MWC,11,80,370,4.6,3,5,21,4.2,0,85,391,4.6,3,marcus-mcelroy-1
175,Jacqez Hairston,Coastal Carolina,Sun Belt,12,79,360,4.6,6,0,0,,0,79,360,4.6,6,jacqez-hairston-1
176,Kevin Mensah,Connecticut,American,12,226,1013,4.5,9,8,91,11.4,0,234,1104,4.7,9,kevin-mensah-1
177,Elijah Collins*,Michigan State,Big Ten,13,222,988,4.5,5,15,99,6.6,0,237,1087,4.6,5,elijah-collins-1
178,Larry Rountree III,Missouri,SEC,12,186,829,4.5,9,13,70,5.4,0,199,899,4.5,9,larry-rountree-iii-1
179,Desmond Ridder*,Cincinnati,American,13,144,650,4.5,5,0,0,,0,144,650,4.5,5,desmond-ridder-1
180,Spencer Sanders*,Oklahoma State,Big 12,11,139,628,4.5,2,0,0,,0,139,628,4.5,2,spencer-sanders-1
181,DeJon Packer,San Jose State,MWC,12,125,567,4.5,11,27,270,10.0,1,152,837,5.5,12,dejon-packer-1
182,Caleb Twyford,Texas State,Sun Belt,11,108,488,4.5,2,27,145,5.4,1,135,633,4.7,3,caleb-twyford-1
183,Caleb Twyford,Texas State,Sun Belt,11,108,488,4.5,2,27,145,5.4,1,135,633,4.7,3,caleb-twyford-2
184,Jordon Brown*,Kansas State,Big 12,11,84,380,4.5,4,14,138,9.9,0,98,518,5.3,4,jordon-brown-1
185,Jamal Jones*,Arkansas State,Sun Belt,10,84,375,4.5,3,6,30,5.0,0,90,405,4.5,3,jamal-jones-4
186,Ta'Zhawn Henry,Texas Tech,Big 12,9,75,340,4.5,3,22,138,6.3,0,97,478,4.9,3,tazhawn-henry-1
187,Tre Harbison,Northern Illinois,MAC,11,230,1021,4.4,8,6,47,7.8,0,236,1068,4.5,8,tre-harbison-1
188,Christopher Brooks*,California,Pac-12,13,208,914,4.4,8,22,166,7.5,4,230,1080,4.7,12,christopher-brooks-1
189,Justin McMillan*,Tulane,American,13,169,745,4.4,12,1,27,27.0,0,170,772,4.5,12,justin-mcmillan-1
190,Shai Werts*,Georgia Southern,Sun Belt,11,170,740,4.4,5,0,0,,0,170,740,4.4,5,shai-werts-1
191,Connor Slomka,Army,Ind,12,149,658,4.4,8,0,0,,0,149,658,4.4,8,connor-slomka-1
192,Davon Jones,Bowling Green State,MAC,9,118,518,4.4,3,15,50,3.3,1,133,568,4.3,4,davon-jones-1
193,Darius Bradwell*,Tulane,American,10,111,484,4.4,2,3,13,4.3,0,114,497,4.4,2,darius-bradwell-1
194,Jarveon Howard,Syracuse,ACC,11,76,337,4.4,3,9,53,5.9,0,85,390,4.6,3,jarveon-howard-1
195,Eno Benjamin*,Arizona State,Pac-12,12,253,1083,4.3,10,42,347,8.3,2,295,1430,4.8,12,eno-benjamin-1
196,J.D. King*,Georgia Southern,Sun Belt,12,185,804,4.3,8,2,14,7.0,0,187,818,4.4,8,jd-king-1
197,Jaylon Bester*,Miami (OH),MAC,11,171,741,4.3,14,12,59,4.9,0,183,800,4.4,14,jaylon-bester-1
198,Isiah Pacheco,Rutgers,Big Ten,11,169,729,4.3,7,13,83,6.4,0,182,812,4.5,7,isaih-pacheco-1
199,Adrian Martinez,Nebraska,Big Ten,10,144,626,4.3,7,0,0,,0,144,626,4.3,7,adrian-martinez-2
200,Sandon McCoy,Army,Ind,13,134,576,4.3,10,0,0,,0,134,576,4.3,10,sandon-mccoy-1
201,Max Duggan,TCU,Big 12,12,130,555,4.3,6,0,0,,0,130,555,4.3,6,max-duggan-1
202,Scottie Phillips,Ole Miss,SEC,10,125,542,4.3,5,8,77,9.6,1,133,619,4.7,6,scottie-phillips-1
203,Richard Newton*,Washington,Pac-12,10,117,498,4.3,10,2,16,8.0,1,119,514,4.3,11,richard-newton-1
204,Grant Loy,Bowling Green State,MAC,12,100,427,4.3,4,0,0,,0,100,427,4.3,4,grant-loy-1
205,Chance Bell*,San Diego State,MWC,12,89,384,4.3,2,12,77,6.4,0,101,461,4.6,2,chance-bell-1
206,Elijah Davis,Old Dominion,CUSA,11,79,337,4.3,4,4,1,0.3,0,83,338,4.1,4,elijah-davis-3
207,Lala Davis,Old Dominion,CUSA,11,79,337,4.3,4,4,1,0.3,0,83,338,4.1,4,lala-davis-1
208,Cameron Scarlett,Stanford,Pac-12,12,201,840,4.2,7,25,240,9.6,0,226,1080,4.8,7,cameron-scarlett-1
209,Dustin Crum*,Kent State,MAC,13,168,707,4.2,6,1,0,0.0,0,169,707,4.2,6,dustin-crum-1
210,Dan Ellington*,Georgia State,Sun Belt,13,160,668,4.2,6,0,0,,0,160,668,4.2,6,dan-ellington-1
211,Kai Locksley,UTEP,CUSA,11,126,535,4.2,5,0,0,,0,126,535,4.2,5,kai-locksley-1
212,A.J. Davis*,Pitt,ACC,11,127,530,4.2,4,23,269,11.7,0,150,799,5.3,4,aj-davis-4
213,A.J. Davis Jr.*,Pitt,ACC,11,127,530,4.2,4,23,269,11.7,0,150,799,5.3,4,aj-davis-jr-1
214,Ke'Mon Freeman*,SMU,American,13,122,517,4.2,5,6,37,6.2,0,128,554,4.3,5,kemon-freemon-1
215,Lowell Narcisse,UTSA,CUSA,11,118,492,4.2,4,0,0,,0,118,492,4.2,4,lowell-narcisse-1
216,Tyler Badie,Missouri,SEC,12,108,457,4.2,3,32,356,11.1,5,140,813,5.8,8,tyler-badie-1
217,Zac Thomas*,Appalachian State,Sun Belt,14,104,440,4.2,7,0,0,,0,104,440,4.2,7,zac-thomas-2
218,Lopini Katoa*,Brigham Young,Ind,12,85,358,4.2,4,24,288,12.0,1,109,646,5.9,5,lopini-katoa-1
219,Kesean Strong,Old Dominion,CUSA,11,84,353,4.2,4,27,200,7.4,0,111,553,5.0,4,kesean-strong-1
220,Toa Taua*,Nevada,MWC,13,196,807,4.1,6,30,185,6.2,0,226,992,4.4,6,toa-taua-1
221,Treyvon Hughes,UTEP,CUSA,12,167,682,4.1,12,1,2,2.0,0,168,684,4.1,12,treyvon-hughes-1
222,Sam Ehlinger*,Texas,Big 12,13,163,663,4.1,7,2,14,7.0,0,165,677,4.1,7,sam-ehlinger-1
223,Drake Anderson,Northwestern,Big Ten,12,154,634,4.1,3,6,28,4.7,0,160,662,4.1,3,drake-anderson-1
224,Jager Gardner*,Temple,American,11,141,585,4.1,5,8,48,6.0,0,149,633,4.2,5,jager-gardner-1
225,Wayne Taulapapa*,Virginia,ACC,12,116,473,4.1,12,5,23,4.6,0,121,496,4.1,12,wayne-taulapapa-1
226,Jaren Mangham,Colorado,Pac-12,12,107,441,4.1,3,10,41,4.1,0,117,482,4.1,3,jaren-mangham-1
227,Tim Jordan*,Tennessee,SEC,12,104,428,4.1,1,6,46,7.7,0,110,474,4.3,1,tim-jordan-2
228,Sewo Olonilua,TCU,Big 12,12,134,537,4.0,8,24,114,4.8,1,158,651,4.1,9,sewo-olonilua-1
229,Kellen Mond*,Texas A&M,SEC,13,126,500,4.0,8,0,0,,0,126,500,4.0,8,kellen-mond-1
230,Cade Carney*,Wake Forest,ACC,11,158,620,3.9,5,7,28,4.0,0,165,648,3.9,5,cade-carney-1
231,Malik Cunningham*,Louisville,ACC,12,123,482,3.9,6,0,0,,0,123,482,3.9,6,malik-cunningham-1
232,Corey Taylor II,Tulsa,American,12,119,461,3.9,6,1,11,11.0,0,120,472,3.9,6,corey-taylor-ii-1
233,Wan'Dale Robinson,Nebraska,Big Ten,10,88,340,3.9,3,40,453,11.3,2,128,793,6.2,5,wandale-robinson-1
234,Abdul Adams,Syracuse,ACC,11,87,336,3.9,3,15,141,9.4,0,102,477,4.7,3,abdul-adams-1
235,Spencer Brown*,UAB,CUSA,12,150,566,3.8,5,3,16,5.3,0,153,582,3.8,5,spencer-brown-3
236,Cole McDonald*,Hawaii,MWC,14,101,383,3.8,7,0,0,,0,101,383,3.8,7,cole-mcdonald-1
237,Demetric Felton,UCLA,Pac-12,12,86,331,3.8,1,55,594,10.8,4,141,925,6.6,5,demetric-felton-1
238,Josh Hokit,Fresno State,MWC,12,75,287,3.8,9,17,97,5.7,1,92,384,4.2,10,josh-hokit-1
239,Deon Jackson,Duke,ACC,12,172,641,3.7,6,21,192,9.1,2,193,833,4.3,8,deon-jackson-1
240,Demetrius Mauney,East Carolina,American,12,125,446,3.6,1,6,47,7.8,0,131,493,3.8,1,demetrius-mauney-1
241,Mike Glass III*,Eastern Michigan,MAC,12,118,428,3.6,8,0,0,,0,118,428,3.6,8,mike-glass-iii-1
242,Skylar Thompson*,Kansas State,Big 12,13,114,405,3.6,11,0,0,,0,114,405,3.6,11,skylar-thompson-1
243,Bryce Carpenter,Coastal Carolina,Sun Belt,11,109,390,3.6,1,0,0,,0,109,390,3.6,1,bryce-carpenter-1
244,Larry McCammon III*,Florida Atlantic,CUSA,9,91,324,3.6,7,13,88,6.8,0,104,412,4.0,7,larry-mccammon-iii-1
245,Justin Fields*,Ohio State,Big Ten,14,137,484,3.5,10,0,0,,0,137,484,3.5,10,justin-fields-2
246,King Doerue,Purdue,Big Ten,12,130,451,3.5,5,20,148,7.4,2,150,599,4.0,7,king-doerue-1
247,Sean Clifford*,Penn State,Big Ten,12,116,402,3.5,5,0,0,,0,116,402,3.5,5,sean-clifford-1
248,Bryce Perkins*,Virginia,ACC,14,227,769,3.4,11,0,0,,0,227,769,3.4,11,bryce-perkins-1
249,Leddie Brown,West Virginia,Big 12,12,107,367,3.4,1,17,145,8.5,1,124,512,4.1,2,leddie-brown-1
250,Juwan Washington*,San Diego State,MWC,9,150,500,3.3,2,17,100,5.9,2,167,600,3.6,4,juwan-washington-1
251,Brian Lewerke*,Michigan State,Big Ten,13,111,363,3.3,3,1,17,17.0,0,112,380,3.4,3,brian-lewerke-1
252,Holton Ahlers,East Carolina,American,12,108,359,3.3,6,0,0,,0,108,359,3.3,6,holton-ahlers-1
253,Kennedy McKoy,West Virginia,Big 12,12,99,323,3.3,3,37,167,4.5,1,136,490,3.6,4,kennedy-mckoy-1
254,Jamie Newman*,Wake Forest,ACC,12,180,574,3.2,6,0,0,,0,180,574,3.2,6,jamie-newman-1
255,Quentin Harris,Duke,ACC,12,160,510,3.2,7,0,0,,0,160,510,3.2,7,quentin-harris-2
256,Joe Burrow*,LSU,SEC,15,115,368,3.2,5,1,16,16.0,0,116,384,3.3,5,joe-burrow-1
257,Bo Nix*,Auburn,SEC,13,97,313,3.2,7,0,0,,0,97,313,3.2,7,bo-nix-1
258,Cam Roberson,Massachusetts,Ind,12,116,355,3.1,2,15,59,3.9,0,131,414,3.2,2,cam-roberson-1
259,Charlie Booker,Rice,CUSA,10,88,272,3.1,1,0,0,,0,88,272,3.1,1,charlie-booker-1
260,Johnny Langan,Rutgers,Big Ten,11,134,391,2.9,3,0,0,,0,134,391,2.9,3,johnny-langan-1
261,Hendon Hooker*,Virginia Tech,ACC,11,123,356,2.9,5,0,-4,,0,123,352,2.9,5,hendon-hooker-1
262,James Graham,Georgia Tech,ACC,11,99,290,2.9,3,0,0,,0,99,290,2.9,3,james-graham-1
263,Jayden Daniels*,Arizona State,Pac-12,12,125,355,2.8,3,0,0,,0,125,355,2.8,3,jayden-daniels-1
264,Tyler Huntley*,Utah,Pac-12,14,104,290,2.8,5,0,0,,0,104,290,2.8,5,tyler-huntley-1
265,Jordan McCloud,South Florida,American,12,105,283,2.7,4,0,0,,0,105,283,2.7,4,jordan-mccloud-1
266,Jorge Reyna,Fresno State,MWC,12,98,264,2.7,2,0,6,,0,98,270,2.8,2,jorge-reyna-1
267,Brock Purdy*,Iowa State,Big 12,13,93,249,2.7,8,0,0,,0,93,249,2.7,8,brock-purdy-1
268,Isaiah Green*,Marshall,CUSA,13,114,300,2.6,5,0,0,,0,114,300,2.6,5,isaiah-green-2
269,J'mar Smith*,Louisiana Tech,CUSA,11,100,264,2.6,4,0,0,,0,100,264,2.6,4,jmar-smith-1
270,Peyton Ramsey*,Indiana,Big Ten,11,97,252,2.6,7,0,0,,0,97,252,2.6,7,peyton-ramsey-1
271,Chase Garbers*,California,Pac-12,9,90,223,2.5,3,0,0,,0,90,223,2.5,3,chase-garbers-1
272,Cephus Johnson,South Alabama,Sun Belt,8,75,181,2.4,4,0,0,,0,75,181,2.4,4,cephus-johnson-2
273,Charlie Brewer*,Baylor,Big 12,14,147,344,2.3,11,0,0,,0,147,344,2.3,11,charlie-brewer-1
274,Ty Storey*,Western Kentucky,CUSA,11,118,276,2.3,7,2,14,7.0,1,120,290,2.4,8,ty-storey-1
275,Kelly Bryant,Missouri,SEC,10,106,242,2.3,1,0,0,,0,106,242,2.3,1,kelly-bryant-1
276,Drew Plitt,Ball State,MAC,12,91,171,1.9,5,1,2,2.0,0,92,173,1.9,5,drew-plitt-1
277,Dorian Thompson-Robinson,UCLA,Pac-12,11,118,198,1.7,4,0,0,,0,118,198,1.7,4,dorian-thompson-robinson-1
278,Stone Smartt,Old Dominion,CUSA,10,104,181,1.7,5,0,0,,0,104,181,1.7,5,stone-smartt-1
279,Kaleb Barker,Troy,Sun Belt,12,86,137,1.6,2,0,0,,0,86,137,1.6,2,kaleb-barker-1
280,Kenny Pickett*,Pitt,ACC,12,95,110,1.2,2,1,3,3.0,1,96,113,1.2,3,kenny-pickett-1
281,Tommy Devito,Syracuse,ACC,12,112,122,1.1,2,1,4,4.0,0,113,126,1.1,2,tommy-devito-1
282,Kato Nelson,Akron,MAC,10,109,116,1.1,0,0,0,,0,109,116,1.1,0,kato-nelson-1
283,Brett Gabbert*,Miami (OH),MAC,14,88,72,0.8,3,0,0,,0,88,72,0.8,3,brett-gabbert-1
284,Shea Patterson*,Michigan,Big Ten,13,87,50,0.6,5,0,0,,0,87,50,0.6,5,shea-patterson-1
285,Josh Adkins,New Mexico State,Ind,12,106,41,0.4,4,2,6,3.0,1,108,47,0.4,5,josh-adkins-1
286,Sam Howell*,North Carolina,ACC,13,94,35,0.4,1,3,23,7.7,1,97,58,0.6,2,sam-howell-1
287,Zach Smith,Tulsa,American,12,75,-96,-1.3,0,0,0,,0,75,-96,-1.3,0,zach-smith-6